Species,Sample ID,Clock 1,Clock 2,Sum,Mean ,Adcyap1,Adcyap2,Sum,Mean
Eur. Blackbird,CG02,7,7,14,7,161,170,331,165.5
Eur. Blackbird,EG06,7,7,14,7,163,165,328,164
Eur. Blackbird,EG07,7,7,14,7,163,169,332,166
Eur. Blackbird,EG04,7,7,14,7,165,165,330,165
Eur. Blackbird,EG01,7,7,14,7,165,165,330,165
Eur. Blackbird,CG14,7,7,14,7,165,165,330,165
Eur. Blackbird,EG09,7,7,14,7,165,165,330,165
Eur. Blackbird,CG18,7,7,14,7,165,165,330,165
Eur. Blackbird,CG04,7,7,14,7,165,167,332,166
Eur. Blackbird,CG16,7,7,14,7,165,167,332,166
Eur. Blackbird,CG06,7,7,14,7,165,167,332,166
Eur. Blackbird,EG10,7,7,14,7,165,169,334,167
Eur. Blackbird,EG05,7,7,14,7,165,169,334,167
Eur. Blackbird,CG07,7,7,14,7,165,169,334,167
Eur. Blackbird,EG03,7,7,14,7,165,169,334,167
Eur. Blackbird,CG01,7,7,14,7,165,169,334,167
Eur. Blackbird,CG11,7,7,14,7,165,170,335,167.5
Eur. Blackbird,CG17,7,7,14,7,165,171,336,168
Eur. Blackbird,CG08,7,7,14,7,167,167,334,167
Eur. Blackbird,EG08,7,7,14,7,167,169,336,168
Eur. Blackbird,CG05,7,7,14,7,167,169,336,168
Eur. Blackbird,CG19,5,5,10,5,167,171,338,169
Eur. Blackbird,CG10,7,7,14,7,167,171,338,169
Eur. Blackbird,CG03,7,7,14,7,167,171,338,169
Eur. Blackbird,CG15,7,7,14,7,167,176,343,171.5
Eur. Blackbird,EG02,7,7,14,7,169,169,338,169
Eur. Blackbird,CG13,7,7,14,7,169,171,340,170
Eur. Blackbird,CG12,7,7,14,7,170,170,340,170
Eur. Blackbird,EG11,7,7,14,7,170,171,341,170.5
Eur. Blackbird,CG09,7,7,14,7,170,171,341,170.5
Eur. Blackbird,BG26,7,7,14,7,159,165,324,162
Eur. Blackbird,BG01,7,7,14,7,159,165,324,162
Eur. Blackbird,BG03,5,7,12,6,163,165,328,164
Eur. Blackbird,BG31,7,7,14,7,163,165,328,164
Eur. Blackbird,BG19,7,7,14,7,163,169,332,166
Eur. Blackbird,BG02,7,7,14,7,163,171,334,167
Eur. Blackbird,BG23,7,7,14,7,165,165,330,165
Eur. Blackbird,BG27,7,7,14,7,165,165,330,165
Eur. Blackbird,BG14,7,7,14,7,165,167,332,166
Eur. Blackbird,BG30,7,7,14,7,165,167,332,166
Eur. Blackbird,BG11,7,7,14,7,165,169,334,167
Eur. Blackbird,BG21,7,7,14,7,165,169,334,167
Eur. Blackbird,BG05,7,7,14,7,165,169,334,167
Eur. Blackbird,BG17,7,7,14,7,165,169,334,167
Eur. Blackbird,BG18,7,7,14,7,165,171,336,168
Eur. Blackbird,BG29,7,7,14,7,165,173,338,169
Eur. Blackbird,BG24,7,7,14,7,165,176,341,170.5
Eur. Blackbird,BG28,7,7,14,7,165,176,341,170.5
Eur. Blackbird,BG20,7,7,14,7,167,167,334,167
Eur. Blackbird,BG08,7,7,14,7,167,170,337,168.5
Eur. Blackbird,BG04,7,7,14,7,167,171,338,169
Eur. Blackbird,BG06,7,7,14,7,167,171,338,169
Eur. Blackbird,BG13,7,7,14,7,167,176,343,171.5
Eur. Blackbird,BG12,7,7,14,7,167,176,343,171.5
Eur. Blackbird,BG10,7,7,14,7,169,171,340,170
Eur. Blackbird,BG22,7,7,14,7,170,171,341,170.5
Eur. Blackbird,BG09,7,7,14,7,171,171,342,171
Eur. Blackbird,BG16,7,7,14,7,171,171,342,171
Eur. Blackbird,BG15,7,7,14,7,171,176,347,173.5
Eur. Blackbird,BG07,7,7,14,7,171,176,347,173.5
Eur. Blackbird,BG25,7,7,14,7,176,176,352,176
Eur. Blackbird,RN20,7,7,14,7,145,165,310,155
Eur. Blackbird,RN27,7,7,14,7,145,165,310,155
Eur. Blackbird,RN26,7,7,14,7,145,167,312,156
Eur. Blackbird,RN04,7,7,14,7,145,170,315,157.5
Eur. Blackbird,RN02,7,7,14,7,145,176,321,160.5
Eur. Blackbird,RN29,7,7,14,7,145,176,321,160.5
Eur. Blackbird,RN23,7,7,14,7,163,164,327,163.5
Eur. Blackbird,RN14,7,7,14,7,163,167,330,165
Eur. Blackbird,RN16,7,7,14,7,163,169,332,166
Eur. Blackbird,RN11,7,7,14,7,164,165,329,164.5
Eur. Blackbird,RN09,7,7,14,7,165,165,330,165
Eur. Blackbird,RN05,7,7,14,7,165,165,330,165
Eur. Blackbird,RN17,7,7,14,7,165,167,332,166
Eur. Blackbird,RN07,7,7,14,7,165,167,332,166
Eur. Blackbird,RN30,7,7,14,7,165,169,334,167
Eur. Blackbird,RN22,7,7,14,7,165,169,334,167
Eur. Blackbird,RN18,7,7,14,7,165,169,334,167
Eur. Blackbird,RN25,7,7,14,7,165,169,334,167
Eur. Blackbird,RN28,7,7,14,7,165,169,334,167
Eur. Blackbird,RN06,7,7,14,7,165,169,334,167
Eur. Blackbird,RN15,7,7,14,7,165,169,334,167
Eur. Blackbird,RN01,7,7,14,7,167,167,334,167
Eur. Blackbird,RN03,7,7,14,7,167,169,336,168
Eur. Blackbird,RN32,7,7,14,7,167,169,336,168
Eur. Blackbird,RN08,7,7,14,7,167,169,336,168
Eur. Blackbird,RN12,7,7,14,7,167,169,336,168
Eur. Blackbird,RN31,7,7,14,7,167,171,338,169
Eur. Blackbird,RN10,7,7,14,7,169,169,338,169
Eur. Blackbird,RN13,7,7,14,7,169,170,339,169.5
Eur. Blackbird,RN21,7,7,14,7,170,174,344,172
Eur. Blackbird,RN24,7,7,14,7,170,176,346,173
Eur. Blackbird,GN31,7,7,14,7,162,171,333,166.5
Eur. Blackbird,GN26,7,7,14,7,163,165,328,164
Eur. Blackbird,GN25,7,7,14,7,163,167,330,165
Eur. Blackbird,GN15,7,7,14,7,163,169,332,166
Eur. Blackbird,GN07,7,7,14,7,164,170,334,167
Eur. Blackbird,GN22,5,7,12,6,165,165,330,165
Eur. Blackbird,GN14,7,7,14,7,165,165,330,165
Eur. Blackbird,GN10,7,7,14,7,165,165,330,165
Eur. Blackbird,GN04,7,7,14,7,165,167,332,166
Eur. Blackbird,GN16,7,7,14,7,165,169,334,167
Eur. Blackbird,GN23,7,7,14,7,165,169,334,167
Eur. Blackbird,GN29,7,7,14,7,165,169,334,167
Eur. Blackbird,GN18,7,7,14,7,165,170,335,167.5
Eur. Blackbird,GN21,7,7,14,7,165,173,338,169
Eur. Blackbird,GN13,5,7,12,6,167,167,334,167
Eur. Blackbird,GN17,7,7,14,7,167,167,334,167
Eur. Blackbird,GN01,7,7,14,7,167,167,334,167
Eur. Blackbird,GN11,7,7,14,7,167,169,336,168
Eur. Blackbird,GN12,7,7,14,7,167,169,336,168
Eur. Blackbird,GN27,7,7,14,7,167,169,336,168
Eur. Blackbird,GN28,7,7,14,7,167,169,336,168
Eur. Blackbird,GN20,7,7,14,7,167,170,337,168.5
Eur. Blackbird,GN02,7,7,14,7,167,170,337,168.5
Eur. Blackbird,GN30,7,7,14,7,167,170,337,168.5
Eur. Blackbird,GN06,7,7,14,7,167,171,338,169
Eur. Blackbird,GN19,7,7,14,7,167,171,338,169
Eur. Blackbird,GN24,7,7,14,7,167,174,341,170.5
Eur. Blackbird,GN03,7,7,14,7,169,169,338,169
Eur. Blackbird,GN05,5,7,12,6,169,170,339,169.5
Eur. Blackbird,GN09,7,7,14,7,169,170,339,169.5
Eur. Blackbird,GN08,7,7,14,7,171,171,342,171
Eur. Blackbird,RP22,7,7,14,7,161,165,326,163
Eur. Blackbird,RP24,7,7,14,7,163,167,330,165
Eur. Blackbird,RP14,7,7,14,7,163,169,332,166
Eur. Blackbird,RP10,7,7,14,7,163,170,333,166.5
Eur. Blackbird,RP19,7,7,14,7,165,165,330,165
Eur. Blackbird,RP23,7,7,14,7,165,167,332,166
Eur. Blackbird,RP06,7,7,14,7,165,167,332,166
Eur. Blackbird,RP15,7,7,14,7,165,167,332,166
Eur. Blackbird,RP01,7,7,14,7,165,167,332,166
Eur. Blackbird,RP18,7,7,14,7,165,167,332,166
Eur. Blackbird,RP20,7,7,14,7,165,168,333,166.5
Eur. Blackbird,RP27,7,7,14,7,165,169,334,167
Eur. Blackbird,RP17,7,7,14,7,165,171,336,168
Eur. Blackbird,RP05,7,7,14,7,165,171,336,168
Eur. Blackbird,RP29,7,7,14,7,165,173,338,169
Eur. Blackbird,RP13,7,7,14,7,165,176,341,170.5
Eur. Blackbird,RP30,7,7,14,7,167,167,334,167
Eur. Blackbird,RP21,7,7,14,7,167,167,334,167
Eur. Blackbird,RP03,7,7,14,7,167,167,334,167
Eur. Blackbird,RP28,7,7,14,7,167,171,338,169
Eur. Blackbird,RP26,7,7,14,7,167,171,338,169
Eur. Blackbird,RP25,7,7,14,7,167,176,343,171.5
Eur. Blackbird,RP07,7,7,14,7,167,176,343,171.5
Eur. Blackbird,RP11,7,7,14,7,167,180,347,173.5
Eur. Blackbird,RP12,7,7,14,7,169,169,338,169
Eur. Blackbird,RP04,7,7,14,7,169,176,345,172.5
Eur. Blackbird,RP08,7,7,14,7,169,176,345,172.5
Eur. Blackbird,RP16,7,7,14,7,170,171,341,170.5
Eur. Blackbird,RP02,7,7,14,7,170,176,346,173
Eur. Blackbird,RP09,7,7,14,7,176,176,352,176
Eur. Blackbird,KP01,7,7,14,7,163,165,328,164
Eur. Blackbird,KP07,7,7,14,7,165,165,330,165
Eur. Blackbird,KP04,7,7,14,7,165,165,330,165
Eur. Blackbird,KP06,7,7,14,7,165,165,330,165
Eur. Blackbird,KP05,7,7,14,7,165,169,334,167
Eur. Blackbird,KP02,7,7,14,7,165,174,339,169.5
Eur. Blackbird,KP03,7,7,14,7,165,174,339,169.5
Eur. Blackbird,KP09,7,7,14,7,165,178,343,171.5
Eur. Blackbird,KP08,7,7,14,7,167,167,334,167
Eur. Blackbird,RS28,7,7,14,7,163,165,328,164
Eur. Blackbird,RS24,7,7,14,7,163,165,328,164
Eur. Blackbird,RS30,7,7,14,7,163,165,328,164
Eur. Blackbird,RS15,7,7,14,7,163,165,328,164
Eur. Blackbird,RS19,7,7,14,7,163,165,328,164
Eur. Blackbird,RS21,5,7,12,6,163,166,329,164.5
Eur. Blackbird,RS01,7,7,14,7,163,167,330,165
Eur. Blackbird,RS10,7,7,14,7,163,176,339,169.5
Eur. Blackbird,RS05,7,7,14,7,165,165,330,165
Eur. Blackbird,RS27,7,7,14,7,165,165,330,165
Eur. Blackbird,RS12,7,7,14,7,165,165,330,165
Eur. Blackbird,RS14,7,7,14,7,165,165,330,165
Eur. Blackbird,RS04,7,7,14,7,165,165,330,165
Eur. Blackbird,RS03,7,7,14,7,165,165,330,165
Eur. Blackbird,RS25,5,7,12,6,165,167,332,166
Eur. Blackbird,RS09,7,7,14,7,165,167,332,166
Eur. Blackbird,RS20,7,7,14,7,165,167,332,166
Eur. Blackbird,RS13,7,7,14,7,165,167,332,166
Eur. Blackbird,RS06,7,7,14,7,165,168,333,166.5
Eur. Blackbird,RS33,7,7,14,7,165,169,334,167
Eur. Blackbird,RS18,7,7,14,7,165,169,334,167
Eur. Blackbird,RS11,7,7,14,7,165,171,336,168
Eur. Blackbird,RS08,7,7,14,7,165,173,338,169
Eur. Blackbird,RS32,7,7,14,7,165,174,339,169.5
Eur. Blackbird,RS29,7,7,14,7,165,176,341,170.5
Eur. Blackbird,RS16,7,7,14,7,165,176,341,170.5
Eur. Blackbird,RS02,7,7,14,7,166,166,332,166
Eur. Blackbird,RS23,7,7,14,7,166,169,335,167.5
Eur. Blackbird,RS31,7,7,14,7,167,168,335,167.5
Eur. Blackbird,RS22,7,7,14,7,167,169,336,168
Eur. Blackbird,RS07,7,7,14,7,167,176,343,171.5
Eur. Blackbird,RS26,7,7,14,7,168,169,337,168.5
Eur. Blackbird,RS17,7,7,14,7,169,173,342,171
Eur. Blackbird,MS06,7,7,14,7,163,169,332,166
Eur. Blackbird,MS10,7,7,14,7,163,170,333,166.5
Eur. Blackbird,MS27,7,7,14,7,165,165,330,165
Eur. Blackbird,MS01,7,7,14,7,165,165,330,165
Eur. Blackbird,MS24,7,7,14,7,165,165,330,165
Eur. Blackbird,MS16,7,7,14,7,165,165,330,165
Eur. Blackbird,MS28,7,7,14,7,165,165,330,165
Eur. Blackbird,MS08,7,7,14,7,165,165,330,165
Eur. Blackbird,MS30,7,7,14,7,165,165,330,165
Eur. Blackbird,MS07,7,7,14,7,165,165,330,165
Eur. Blackbird,MS20,7,7,14,7,165,165,330,165
Eur. Blackbird,MS23,7,7,14,7,165,165,330,165
Eur. Blackbird,MS29,7,7,14,7,165,165,330,165
Eur. Blackbird,MS19,7,7,14,7,165,165,330,165
Eur. Blackbird,MS05,7,7,14,7,165,167,332,166
Eur. Blackbird,MS02,7,7,14,7,165,167,332,166
Eur. Blackbird,MS25,7,7,14,7,165,167,332,166
Eur. Blackbird,MS09,7,7,14,7,165,167,332,166
Eur. Blackbird,MS18,7,7,14,7,165,167,332,166
Eur. Blackbird,MS14,7,7,14,7,165,170,335,167.5
Eur. Blackbird,MS15,7,7,14,7,165,170,335,167.5
Eur. Blackbird,MS11,7,7,14,7,165,170,335,167.5
Eur. Blackbird,MS04,7,7,14,7,165,170,335,167.5
Eur. Blackbird,MS12,7,7,14,7,165,170,335,167.5
Eur. Blackbird,MS13,7,7,14,7,165,170,335,167.5
Eur. Blackbird,MS21,7,7,14,7,165,170,335,167.5
Eur. Blackbird,MS17,7,7,14,7,165,170,335,167.5
Eur. Blackbird,MS03,7,7,14,7,165,170,335,167.5
Eur. Blackbird,MS31,7,7,14,7,167,174,341,170.5
Eur. Blackbird,MS22,7,7,14,7,168,170,338,169
Eur. Blackbird,MS26,7,7,14,7,168,170,338,169
Eur. Blackbird,MG18,7,7,14,7,161,163,324,162
Eur. Blackbird,ea4412,7,7,14,7,163,167,330,165
Eur. Blackbird,ea4468,7,7,14,7,163,167,330,165
Eur. Blackbird,ea4425,7,7,14,7,163,171,334,167
Eur. Blackbird,ea4503,7,7,14,7,164,167,331,165.5
Eur. Blackbird,MG49,7,7,14,7,164,167,331,165.5
Eur. Blackbird,ea4521,7,7,14,7,164,167,331,165.5
Eur. Blackbird,ea4451,7,7,14,7,164,167,331,165.5
Eur. Blackbird,MG54,7,7,14,7,164,169,333,166.5
Eur. Blackbird,ea4441,7,7,14,7,165,165,330,165
Eur. Blackbird,MG07,7,7,14,7,165,165,330,165
Eur. Blackbird,ea4148,7,7,14,7,165,165,330,165
Eur. Blackbird,MG41,7,7,14,7,165,165,330,165
Eur. Blackbird,MG56,7,7,14,7,165,167,332,166
Eur. Blackbird,ea4510,7,7,14,7,165,167,332,166
Eur. Blackbird,MG28,7,7,14,7,165,167,332,166
Eur. Blackbird,ea4444,7,7,14,7,165,167,332,166
Eur. Blackbird,MG58,7,7,14,7,165,167,332,166
Eur. Blackbird,MG47,7,7,14,7,165,167,332,166
Eur. Blackbird,ea4466,7,7,14,7,165,167,332,166
Eur. Blackbird,ea4185,7,7,14,7,165,167,332,166
Eur. Blackbird,MG16,7,7,14,7,165,169,334,167
Eur. Blackbird,MG48,7,7,14,7,165,169,334,167
Eur. Blackbird,MG52,7,7,14,7,165,169,334,167
Eur. Blackbird,MG35,7,7,14,7,165,170,335,167.5
Eur. Blackbird,ea4486,7,7,14,7,165,170,335,167.5
Eur. Blackbird,MG51,7,7,14,7,165,171,336,168
Eur. Blackbird,ea4149,7,7,14,7,165,171,336,168
Eur. Blackbird,MG42,7,7,14,7,165,171,336,168
Eur. Blackbird,MG31,7,7,14,7,165,172,337,168.5
Eur. Blackbird,ea4340,7,7,14,7,165,176,341,170.5
Eur. Blackbird,MG55,7,7,14,7,165,176,341,170.5
Eur. Blackbird,MG27,5,7,12,6,165,179,344,172
Eur. Blackbird,MG57,7,7,14,7,166,171,337,168.5
Eur. Blackbird,MG39,7,7,14,7,167,167,334,167
Eur. Blackbird,ea4479,7,7,14,7,167,167,334,167
Eur. Blackbird,MG08,7,7,14,7,167,167,334,167
Eur. Blackbird,MG05,7,7,14,7,167,167,334,167
Eur. Blackbird,MG03,7,7,14,7,167,167,334,167
Eur. Blackbird,ea4453,5,7,12,6,167,169,336,168
Eur. Blackbird,ea4145,7,7,14,7,167,169,336,168
Eur. Blackbird,MG53,7,7,14,7,167,169,336,168
Eur. Blackbird,MG59,7,7,14,7,167,169,336,168
Eur. Blackbird,ea4443,7,7,14,7,167,171,338,169
Eur. Blackbird,MG04,7,7,14,7,167,171,338,169
Eur. Blackbird,ea4485,7,7,14,7,167,176,343,171.5
Eur. Blackbird,ea4442,7,7,14,7,167,176,343,171.5
Eur. Blackbird,ea4147,7,7,14,7,167,176,343,171.5
Eur. Blackbird,ea4455,7,7,14,7,167,176,343,171.5
Eur. Blackbird,ea4487,7,7,14,7,167,179,346,173
Eur. Blackbird,ea4546,7,7,14,7,169,169,338,169
Eur. Blackbird,MG25,5,7,12,6,169,176,345,172.5
Eur. Blackbird,MG17,7,7,14,7,169,176,345,172.5
Eur. Blackbird,ea4469,7,7,14,7,169,176,345,172.5
Eur. Blackbird,ea4169,7,7,14,7,169,176,345,172.5
Eur. Blackbird,MG23,7,7,14,7,169,178,347,173.5
Eur. Blackbird,MG06,7,7,14,7,170,171,341,170.5
Eur. Blackbird,MG29,7,7,14,7,165,165,330,165
Eur. Blackbird,MG50,7,7,14,7,165,165,330,165
Eur. Blackbird,MG43,7,7,14,7,165,165,330,165
Eur. Blackbird,MG32,7,7,14,7,165,167,332,166
Eur. Blackbird,ea4456,7,7,14,7,165,167,332,166
Eur. Blackbird,ea4474,7,7,14,7,165,167,332,166
Eur. Blackbird,MG10,7,7,14,7,165,167,332,166
Eur. Blackbird,MG33,7,7,14,7,165,167,332,166
Eur. Blackbird,ea4488,7,7,14,7,165,167,332,166
Eur. Blackbird,ea4297,7,7,14,7,165,167,332,166
Eur. Blackbird,MG34,7,7,14,7,165,167,332,166
Eur. Blackbird,MG26,7,7,14,7,165,167,332,166
Eur. Blackbird,MG13,7,7,14,7,165,168,333,166.5
Eur. Blackbird,MG45,7,7,14,7,165,169,334,167
Eur. Blackbird,MG60,7,7,14,7,165,169,334,167
Eur. Blackbird,ea4133,7,7,14,7,165,170,335,167.5
Eur. Blackbird,MG44,7,7,14,7,165,170,335,167.5
Eur. Blackbird,MG11,7,7,14,7,165,171,336,168
Eur. Blackbird,ea4144,7,7,14,7,165,171,336,168
Eur. Blackbird,ea4158,7,7,14,7,165,176,341,170.5
Eur. Blackbird,ea4478,5,7,12,6,167,167,334,167
Eur. Blackbird,ea4178,7,7,14,7,167,167,334,167
Eur. Blackbird,ea4354,7,7,14,7,167,167,334,167
Eur. Blackbird,ea4459,7,7,14,7,167,167,334,167
Eur. Blackbird,ea4315,7,7,14,7,167,167,334,167
Eur. Blackbird,ea4461,7,7,14,7,167,167,334,167
Eur. Blackbird,ea4137,7,7,14,7,167,167,334,167
Eur. Blackbird,MG20,7,7,14,7,167,167,334,167
Eur. Blackbird,ea4433,7,7,14,7,167,167,334,167
Eur. Blackbird,MG38,7,7,14,7,167,167,334,167
Eur. Blackbird,MG01,7,7,14,7,167,167,334,167
Eur. Blackbird,ea4154,7,7,14,7,167,167,334,167
Eur. Blackbird,MG30,7,7,14,7,167,167,334,167
Eur. Blackbird,MG40,7,7,14,7,167,169,336,168
Eur. Blackbird,ea4477,7,7,14,7,167,169,336,168
Eur. Blackbird,ea4117,7,7,14,7,167,169,336,168
Eur. Blackbird,ea4460,7,7,14,7,167,169,336,168
Eur. Blackbird,ea4489,7,7,14,7,167,169,336,168
Eur. Blackbird,ea4301,7,7,14,7,167,169,336,168
Eur. Blackbird,ea4170,7,7,14,7,167,169,336,168
Eur. Blackbird,ea4463,7,7,14,7,167,169,336,168
Eur. Blackbird,ea4174,7,7,14,7,167,169,336,168
Eur. Blackbird,ea4138,7,7,14,7,167,169,336,168
Eur. Blackbird,ea4194,7,7,14,7,167,169,336,168
Eur. Blackbird,ea4480,7,7,14,7,167,169,336,168
Eur. Blackbird,MG02,7,7,14,7,167,169,336,168
Eur. Blackbird,ea4475,7,7,14,7,167,169,336,168
Eur. Blackbird,MG19,7,7,14,7,167,169,336,168
Eur. Blackbird,MG09,7,7,14,7,167,169,336,168
Eur. Blackbird,MG24,7,7,14,7,167,169,336,168
Eur. Blackbird,ea4411,7,7,14,7,167,169,336,168
Eur. Blackbird,MG14,7,7,14,7,167,170,337,168.5
Eur. Blackbird,MG21,7,7,14,7,167,170,337,168.5
Eur. Blackbird,ea4175,7,7,14,7,167,171,338,169
Eur. Blackbird,MG46,7,7,14,7,167,171,338,169
Eur. Blackbird,ea4472,7,7,14,7,167,171,338,169
Eur. Blackbird,ea4310,7,7,14,7,167,171,338,169
Eur. Blackbird,ea4199,7,7,14,7,167,171,338,169
Eur. Blackbird,MG36,7,7,14,7,167,171,338,169
Eur. Blackbird,ea4312,7,7,14,7,167,174,341,170.5
Eur. Blackbird,ea4131,7,7,14,7,167,174,341,170.5
Eur. Blackbird,ea4471,7,7,14,7,167,174,341,170.5
Eur. Blackbird,ea4123,7,7,14,7,167,174,341,170.5
Eur. Blackbird,ea4143,7,7,14,7,167,174,341,170.5
Eur. Blackbird,MG22,7,7,14,7,169,169,338,169
Eur. Blackbird,ea4142,7,7,14,7,169,169,338,169
Eur. Blackbird,ea4197,7,7,14,7,169,169,338,169
Eur. Blackbird,ea4171,7,7,14,7,169,171,340,170
Eur. Blackbird,ea4134,7,7,14,7,169,171,340,170
Eur. Blackbird,MG15,7,7,14,7,169,171,340,170
Eur. Blackbird,ea4483,7,7,14,7,169,174,343,171.5
Eur. Blackbird,MG37,7,7,14,7,169,174,343,171.5
Eur. Blackbird,ea4136,7,7,14,7,169,176,345,172.5
Eur. Blackbird,MG12,7,7,14,7,169,177,346,173
Eur. Blackbird,ea4190,7,7,14,7,171,171,342,171
Eur. Blackbird,ea4352,7,7,14,7,174,176,350,175
Eur. Blackbird,RC27,7,7,14,7,158,167,325,162.5
Eur. Blackbird,RC07,7,7,14,7,163,165,328,164
Eur. Blackbird,RC15,7,7,14,7,163,167,330,165
Eur. Blackbird,RC22,7,7,14,7,163,171,334,167
Eur. Blackbird,RC03,7,7,14,7,165,165,330,165
Eur. Blackbird,RC17,7,7,14,7,165,167,332,166
Eur. Blackbird,RC01,7,7,14,7,165,167,332,166
Eur. Blackbird,RC16,7,7,14,7,165,167,332,166
Eur. Blackbird,RC20,7,7,14,7,165,167,332,166
Eur. Blackbird,RC29,7,7,14,7,165,167,332,166
Eur. Blackbird,RC14,7,7,14,7,165,169,334,167
Eur. Blackbird,RC19,7,7,14,7,165,169,334,167
Eur. Blackbird,RC02,7,7,14,7,165,169,334,167
Eur. Blackbird,RC09,7,7,14,7,165,169,334,167
Eur. Blackbird,RC12,7,7,14,7,165,171,336,168
Eur. Blackbird,RC21,7,7,14,7,165,173,338,169
Eur. Blackbird,RC25,7,7,14,7,165,174,339,169.5
Eur. Blackbird,RC10,7,7,14,7,167,167,334,167
Eur. Blackbird,RC04,7,7,14,7,167,167,334,167
Eur. Blackbird,RC23,7,7,14,7,167,167,334,167
Eur. Blackbird,RC26,7,7,14,7,167,169,336,168
Eur. Blackbird,RC18,7,7,14,7,167,171,338,169
Eur. Blackbird,RC30,7,7,14,7,167,171,338,169
Eur. Blackbird,RC24,7,7,14,7,167,173,340,170
Eur. Blackbird,RC11,7,7,14,7,167,174,341,170.5
Eur. Blackbird,RC28,7,7,14,7,167,174,341,170.5
Eur. Blackbird,RC13,7,7,14,7,167,174,341,170.5
Eur. Blackbird,RC05,7,7,14,7,167,174,341,170.5
Eur. Blackbird,RC06,7,7,14,7,170,171,341,170.5
Eur. Blackbird,RC08,7,7,14,7,170,174,344,172
Eur. Blackbird,PC09,7,7,14,7,163,165,328,164
Eur. Blackbird,PC23,7,7,14,7,163,165,328,164
Eur. Blackbird,PC06,7,7,14,7,163,167,330,165
Eur. Blackbird,PC04,7,7,14,7,163,173,336,168
Eur. Blackbird,PC29,7,7,14,7,163,173,336,168
Eur. Blackbird,PC02,7,7,14,7,165,165,330,165
Eur. Blackbird,PC18,7,7,14,7,165,167,332,166
Eur. Blackbird,PC22,7,7,14,7,165,167,332,166
Eur. Blackbird,PC28,7,7,14,7,165,167,332,166
Eur. Blackbird,PC12,7,7,14,7,165,169,334,167
Eur. Blackbird,PC11,7,7,14,7,165,169,334,167
Eur. Blackbird,PC25,7,7,14,7,165,173,338,169
Eur. Blackbird,PC24,7,7,14,7,165,173,338,169
Eur. Blackbird,PC05,7,7,14,7,165,176,341,170.5
Eur. Blackbird,PC19,7,7,14,7,165,176,341,170.5
Eur. Blackbird,PC07,7,7,14,7,165,176,341,170.5
Eur. Blackbird,PC15,7,7,14,7,165,176,341,170.5
Eur. Blackbird,PC03,7,7,14,7,165,178,343,171.5
Eur. Blackbird,PC10,7,7,14,7,167,167,334,167
Eur. Blackbird,PC08,7,7,14,7,167,167,334,167
Eur. Blackbird,PC20,7,7,14,7,167,169,336,168
Eur. Blackbird,PC17,7,7,14,7,167,171,338,169
Eur. Blackbird,PC21,7,7,14,7,167,171,338,169
Eur. Blackbird,PC16,7,7,14,7,167,173,340,170
Eur. Blackbird,PC14,7,7,14,7,167,173,340,170
Eur. Blackbird,PC30,7,7,14,7,167,174,341,170.5
Eur. Blackbird,PC13,7,7,14,7,167,176,343,171.5
Eur. Blackbird,PC27,7,7,14,7,171,171,342,171
Eur. Blackbird,PC26,7,7,14,7,171,173,344,172
Eur. Blackbird,PC01,7,7,14,7,174,176,350,175
Eur. Blackbird,RL26,7,7,14,7,163,165,328,164
Eur. Blackbird,RL19,7,7,14,7,163,175,338,169
Eur. Blackbird,RL21,7,7,14,7,165,165,330,165
Eur. Blackbird,RL27,7,7,14,7,165,165,330,165
Eur. Blackbird,RL20,7,7,14,7,165,165,330,165
Eur. Blackbird,RL05,7,7,14,7,165,166,331,165.5
Eur. Blackbird,RL04,7,7,14,7,165,167,332,166
Eur. Blackbird,RL24,7,7,14,7,165,169,334,167
Eur. Blackbird,RL23,7,7,14,7,165,170,335,167.5
Eur. Blackbird,RL06,7,7,14,7,165,170,335,167.5
Eur. Blackbird,RL10,7,7,14,7,165,171,336,168
Eur. Blackbird,RL07,7,7,14,7,165,171,336,168
Eur. Blackbird,RL18,7,7,14,7,165,171,336,168
Eur. Blackbird,RL22,7,7,14,7,166,171,337,168.5
Eur. Blackbird,RL17,7,7,14,7,167,169,336,168
Eur. Blackbird,RL03,7,7,14,7,167,169,336,168
Eur. Blackbird,RL25,7,7,14,7,167,170,337,168.5
Eur. Blackbird,RL12,7,7,14,7,167,170,337,168.5
Eur. Blackbird,RL15,7,7,14,7,167,170,337,168.5
Eur. Blackbird,RL16,5,7,12,6,167,171,338,169
Eur. Blackbird,RL11,7,7,14,7,167,176,343,171.5
Eur. Blackbird,RL13,5,7,12,6,169,170,339,169.5
Eur. Blackbird,RL14,7,7,14,7,169,171,340,170
Eur. Blackbird,RL01,7,7,14,7,169,174,343,171.5
Eur. Blackbird,RL09,7,7,14,7,169,175,344,172
Eur. Blackbird,RL02,7,7,14,7,174,175,349,174.5
Eur. Blackbird,UL05,7,7,14,7,163,167,330,165
Eur. Blackbird,UL07,7,7,14,7,165,165,330,165
Eur. Blackbird,UL04,7,7,14,7,165,167,332,166
Eur. Blackbird,UL06,7,7,14,7,165,169,334,167
Eur. Blackbird,UL11,7,7,14,7,165,169,334,167
Eur. Blackbird,UL10,7,7,14,7,165,170,335,167.5
Eur. Blackbird,UL17,7,7,14,7,165,170,335,167.5
Eur. Blackbird,UL14,7,7,14,7,165,175,340,170
Eur. Blackbird,UL15,7,7,14,7,165,178,343,171.5
Eur. Blackbird,UL01,7,7,14,7,167,169,336,168
Eur. Blackbird,UL09,7,7,14,7,167,169,336,168
Eur. Blackbird,UL08,7,7,14,7,167,170,337,168.5
Eur. Blackbird,UL16,7,7,14,7,167,178,345,172.5
Eur. Blackbird,UL13,7,7,14,7,169,170,339,169.5
Eur. Blackbird,UL03,7,7,14,7,170,171,341,170.5
Eur. Blackbird,UL12,7,7,14,7,170,171,341,170.5
Eur. Blackbird,UL02,7,7,14,7,171,178,349,174.5
Eur. Blackbird,SE36,5,7,12,6,161,163,324,162
Eur. Blackbird,SE44,7,7,14,7,161,165,326,163
Eur. Blackbird,SE46,7,7,14,7,163,165,328,164
Eur. Blackbird,SE25,7,7,14,7,163,167,330,165
Eur. Blackbird,SE22,7,7,14,7,163,169,332,166
Eur. Blackbird,SE45,7,7,14,7,163,170,333,166.5
Eur. Blackbird,SE57,7,7,14,7,164,165,329,164.5
Eur. Blackbird,SE52,7,7,14,7,165,165,330,165
Eur. Blackbird,SE51,7,7,14,7,165,165,330,165
Eur. Blackbird,SE43,5,7,12,6,165,167,332,166
Eur. Blackbird,SE24,7,7,14,7,165,167,332,166
Eur. Blackbird,SE35,7,7,14,7,165,167,332,166
Eur. Blackbird,SE26,7,7,14,7,165,169,334,167
Eur. Blackbird,SE32,7,7,14,7,165,169,334,167
Eur. Blackbird,SE54,5,7,12,6,165,170,335,167.5
Eur. Blackbird,SE23,7,7,14,7,165,170,335,167.5
Eur. Blackbird,SE33,7,7,14,7,165,170,335,167.5
Eur. Blackbird,SE29,5,7,12,6,165,171,336,168
Eur. Blackbird,SE55,7,7,14,7,165,173,338,169
Eur. Blackbird,SE30,7,7,14,7,165,173,338,169
Eur. Blackbird,SE50,7,7,14,7,167,169,336,168
Eur. Blackbird,SE31,7,7,14,7,167,169,336,168
Eur. Blackbird,SE53,7,7,14,7,167,169,336,168
Eur. Blackbird,SE56,7,7,14,7,167,169,336,168
Eur. Blackbird,SE47,7,7,14,7,167,171,338,169
Eur. Blackbird,SE37,7,7,14,7,168,170,338,169
Eur. Blackbird,SE27,7,7,14,7,168,171,339,169.5
Eur. Blackbird,SE28,7,7,14,7,169,171,340,170
Eur. Blackbird,SE49,7,7,14,7,169,171,340,170
Eur. Blackbird,SE48,7,7,14,7,169,171,340,170
Eur. Blackbird,SE34,7,7,14,7,171,171,342,171
Eur. Blackbird,SE68,7,7,14,7,161,176,337,168.5
Eur. Blackbird,SE19,7,7,14,7,163,165,328,164
Eur. Blackbird,SE10,7,7,14,7,163,165,328,164
Eur. Blackbird,SE08,7,7,14,7,163,169,332,166
Eur. Blackbird,SE06,7,7,14,7,165,165,330,165
Eur. Blackbird,SE05,7,7,14,7,165,165,330,165
Eur. Blackbird,SE12,7,7,14,7,165,165,330,165
Eur. Blackbird,SE64,5,7,12,6,165,167,332,166
Eur. Blackbird,SE11,7,7,14,7,165,169,334,167
Eur. Blackbird,SE69,7,7,14,7,165,169,334,167
Eur. Blackbird,SE61,7,7,14,7,165,170,335,167.5
Eur. Blackbird,SE03,7,7,14,7,165,171,336,168
Eur. Blackbird,SE04,7,7,14,7,165,171,336,168
Eur. Blackbird,SE07,7,7,14,7,165,171,336,168
Eur. Blackbird,SE62,7,7,14,7,165,176,341,170.5
Eur. Blackbird,SE18,7,7,14,7,167,167,334,167
Eur. Blackbird,SE14,7,7,14,7,167,167,334,167
Eur. Blackbird,SE58,7,7,14,7,167,167,334,167
Eur. Blackbird,SE16,7,7,14,7,167,169,336,168
Eur. Blackbird,SE13,7,7,14,7,167,169,336,168
Eur. Blackbird,SE60,7,7,14,7,167,170,337,168.5
Eur. Blackbird,SE21,7,7,14,7,169,169,338,169
Eur. Blackbird,SE20,7,7,14,7,169,170,339,169.5
Eur. Blackbird,SE17,7,7,14,7,169,171,340,170
Eur. Blackbird,SE15,7,7,14,7,169,171,340,170
Eur. Blackbird,SE65,7,7,14,7,169,171,340,170
Eur. Blackbird,SE66,7,7,14,7,169,171,340,170
Eur. Blackbird,SE63,7,7,14,7,169,178,347,173.5
Eur. Blackbird,SE59,7,7,14,7,170,171,341,170.5
Eur. Blackbird,SE67,7,7,14,7,171,171,342,171
Eur. Blackbird,SE09,5,7,12,6,175,176,351,175.5
Eur. Blackbird,RP34,7,7,14,7,163,165,328,164
Eur. Blackbird,RP31,7,7,14,7,163,165,328,164
Eur. Blackbird,RP59,7,7,14,7,163,167,330,165
Eur. Blackbird,RP46,7,7,14,7,164,169,333,166.5
Eur. Blackbird,RP35,5,7,12,6,165,165,330,165
Eur. Blackbird,RP37,5,7,12,6,165,167,332,166
Eur. Blackbird,RP40,7,7,14,7,165,167,332,166
Eur. Blackbird,RP60,7,7,14,7,165,167,332,166
Eur. Blackbird,RP56,7,7,14,7,165,167,332,166
Eur. Blackbird,RP57,7,7,14,7,165,167,332,166
Eur. Blackbird,RP32,7,7,14,7,165,169,334,167
Eur. Blackbird,RP44,7,7,14,7,165,169,334,167
Eur. Blackbird,RP47,7,7,14,7,165,169,334,167
Eur. Blackbird,RP45,7,7,14,7,165,169,334,167
Eur. Blackbird,RP61,7,7,14,7,165,169,334,167
Eur. Blackbird,RP33,7,7,14,7,165,170,335,167.5
Eur. Blackbird,RP38,7,7,14,7,165,171,336,168
Eur. Blackbird,RP52,7,7,14,7,167,167,334,167
Eur. Blackbird,RP50,7,7,14,7,167,167,334,167
Eur. Blackbird,RP49,7,7,14,7,167,167,334,167
Eur. Blackbird,RP58,7,7,14,7,167,169,336,168
Eur. Blackbird,RP48,7,7,14,7,167,169,336,168
Eur. Blackbird,RP41,7,7,14,7,167,169,336,168
Eur. Blackbird,RP42,7,7,14,7,167,171,338,169
Eur. Blackbird,RP39,7,7,14,7,167,173,340,170
Eur. Blackbird,RP54,7,7,14,7,167,176,343,171.5
Eur. Blackbird,RP43,7,7,14,7,167,176,343,171.5
Eur. Blackbird,RP51,7,7,14,7,169,169,338,169
Eur. Blackbird,RP55,7,7,14,7,169,171,340,170
Eur. Blackbird,RP36,7,7,14,7,169,176,345,172.5
Eur. Blackbird,RP53,7,7,14,7,170,170,340,170
Eur. Blackbird,SP49,5,7,12,6,163,165,328,164
Eur. Blackbird,SP71,7,7,14,7,163,165,328,164
Eur. Blackbird,SP50,7,7,14,7,165,165,330,165
Eur. Blackbird,SP69,7,7,14,7,165,165,330,165
Eur. Blackbird,SP47,7,7,14,7,165,167,332,166
Eur. Blackbird,SP63,7,7,14,7,165,167,332,166
Eur. Blackbird,SP51,7,7,14,7,165,169,334,167
Eur. Blackbird,SP66,7,7,14,7,165,169,334,167
Eur. Blackbird,SP44,7,7,14,7,165,169,334,167
Eur. Blackbird,SP54,7,7,14,7,165,170,335,167.5
Eur. Blackbird,SP60,7,7,14,7,165,171,336,168
Eur. Blackbird,SP53,7,7,14,7,167,167,334,167
Eur. Blackbird,SP46,7,7,14,7,167,169,336,168
Eur. Blackbird,SP45,7,7,14,7,167,169,336,168
Eur. Blackbird,SP61,7,7,14,7,167,169,336,168
Eur. Blackbird,SP65,7,7,14,7,167,170,337,168.5
Eur. Blackbird,SP64,7,7,14,7,167,170,337,168.5
Eur. Blackbird,SP56,7,7,14,7,167,170,337,168.5
Eur. Blackbird,SP43,7,7,14,7,167,170,337,168.5
Eur. Blackbird,SP68,7,7,14,7,167,171,338,169
Eur. Blackbird,SP72,7,7,14,7,167,171,338,169
Eur. Blackbird,SP55,7,7,14,7,169,171,340,170
Eur. Blackbird,SP67,7,7,14,7,169,171,340,170
Eur. Blackbird,SP59,7,7,14,7,169,171,340,170
Eur. Blackbird,SP58,7,7,14,7,169,171,340,170
Eur. Blackbird,SP41,7,7,14,7,169,171,340,170
Eur. Blackbird,SP70,7,7,14,7,169,171,340,170
Eur. Blackbird,SP48,7,7,14,7,170,171,341,170.5
Eur. Blackbird,SP52,7,7,14,7,170,171,341,170.5
Eur. Blackbird,SP62,7,7,14,7,170,173,343,171.5
Eur. Blackbird,SP57,7,7,14,7,171,171,342,171
Eur. Blackbird,SP42,7,7,14,7,171,171,342,171
Eur. Blackbird,RE05,7,7,14,7,163,167,330,165
Eur. Blackbird,RE11,7,7,14,7,163,167,330,165
Eur. Blackbird,RE13,7,7,14,7,164,165,329,164.5
Eur. Blackbird,RE08,7,7,14,7,165,165,330,165
Eur. Blackbird,RE20,7,7,14,7,165,165,330,165
Eur. Blackbird,RE04,7,7,14,7,165,165,330,165
Eur. Blackbird,RE06,7,7,14,7,165,165,330,165
Eur. Blackbird,RE18,7,7,14,7,165,167,332,166
Eur. Blackbird,RE03,7,7,14,7,165,167,332,166
Eur. Blackbird,RE09,7,7,14,7,165,167,332,166
Eur. Blackbird,RE12,7,7,14,7,165,167,332,166
Eur. Blackbird,RE15,7,7,14,7,165,169,334,167
Eur. Blackbird,RE01,7,7,14,7,165,171,336,168
Eur. Blackbird,RE16,7,7,14,7,165,171,336,168
Eur. Blackbird,RE19,7,7,14,7,165,176,341,170.5
Eur. Blackbird,RE22,7,7,14,7,167,170,337,168.5
Eur. Blackbird,RE21,7,7,14,7,167,170,337,168.5
Eur. Blackbird,RE10,7,7,14,7,169,170,339,169.5
Eur. Blackbird,RE17,7,7,14,7,170,171,341,170.5
Eur. Blackbird,RE14,7,7,14,7,171,171,342,171
Eur. Blackbird,RE07,7,7,14,7,171,173,344,172
Eur. Blackbird,RE02,7,7,14,7,171,174,345,172.5
Eur. Blackbird,TE11,7,7,14,7,158,161,319,159.5
Eur. Blackbird,TE20,7,7,14,7,158,163,321,160.5
Eur. Blackbird,TE22,7,7,14,7,158,167,325,162.5
Eur. Blackbird,TE07,7,7,14,7,158,171,329,164.5
Eur. Blackbird,TE14,7,7,14,7,161,163,324,162
Eur. Blackbird,TE05,7,7,14,7,161,165,326,163
Eur. Blackbird,TE24,7,7,14,7,161,168,329,164.5
Eur. Blackbird,TE16,7,7,14,7,161,169,330,165
Eur. Blackbird,TE09,7,7,14,7,163,165,328,164
Eur. Blackbird,TE23,7,7,14,7,163,167,330,165
Eur. Blackbird,TE02,7,7,14,7,163,169,332,166
Eur. Blackbird,TE17,5,7,12,6,165,165,330,165
Eur. Blackbird,TE13,7,7,14,7,165,165,330,165
Eur. Blackbird,TE01,7,7,14,7,165,167,332,166
Eur. Blackbird,TE06,7,7,14,7,165,167,332,166
Eur. Blackbird,TE04,7,7,14,7,165,169,334,167
Eur. Blackbird,TE03,7,7,14,7,165,170,335,167.5
Eur. Blackbird,TE10,7,7,14,7,165,171,336,168
Eur. Blackbird,TE08,7,7,14,7,165,176,341,170.5
Eur. Blackbird,TE12,7,7,14,7,167,167,334,167
Eur. Blackbird,TE21,7,7,14,7,167,169,336,168
Eur. Blackbird,TE19,7,7,14,7,167,169,336,168
Eur. Blackbird,TE18,7,7,14,7,167,176,343,171.5
Eur. Blackbird,TE15,7,7,14,7,169,170,339,169.5
Eur. Blackbird,TE26,7,7,14,7,169,176,345,172.5
Eur. Blackbird,TE25,7,7,14,7,171,173,344,172
Eur. Blackbird,WT16,7,7,14,7,151,163,314,157
Eur. Blackbird,WT11,7,7,14,7,151,165,316,158
Eur. Blackbird,WT09,7,7,14,7,163,163,326,163
Eur. Blackbird,RT26,7,7,14,7,163,163,326,163
Eur. Blackbird,WT29,7,7,14,7,163,163,326,163
Eur. Blackbird,WT01,7,7,14,7,163,163,326,163
Eur. Blackbird,WT17,7,7,14,7,163,164,327,163.5
Eur. Blackbird,WT24,7,7,14,7,163,165,328,164
Eur. Blackbird,RT28,7,7,14,7,163,165,328,164
Eur. Blackbird,WT05,7,7,14,7,163,165,328,164
Eur. Blackbird,WT03,7,7,14,7,163,165,328,164
Eur. Blackbird,RT18,7,7,14,7,163,165,328,164
Eur. Blackbird,WT30,7,7,14,7,163,165,328,164
Eur. Blackbird,WT25,7,7,14,7,163,166,329,164.5
Eur. Blackbird,WT13,7,7,14,7,163,166,329,164.5
Eur. Blackbird,RT12,7,7,14,7,163,167,330,165
Eur. Blackbird,RT20,7,7,14,7,163,170,333,166.5
Eur. Blackbird,RT07,7,7,14,7,163,171,334,167
Eur. Blackbird,WT10,7,7,14,7,163,171,334,167
Eur. Blackbird,WT18,7,7,14,7,163,171,334,167
Eur. Blackbird,WT15,7,7,14,7,163,171,334,167
Eur. Blackbird,WT12,7,7,14,7,163,178,341,170.5
Eur. Blackbird,WT28,7,7,14,7,164,164,328,164
Eur. Blackbird,RT15,7,7,14,7,165,165,330,165
Eur. Blackbird,RT03,7,7,14,7,165,165,330,165
Eur. Blackbird,RT23,7,7,14,7,165,165,330,165
Eur. Blackbird,WT06,7,7,14,7,165,165,330,165
Eur. Blackbird,RT09,7,7,14,7,165,165,330,165
Eur. Blackbird,RT05,7,7,14,7,165,165,330,165
Eur. Blackbird,RT13,7,7,14,7,165,165,330,165
Eur. Blackbird,WT04,7,7,14,7,165,165,330,165
Eur. Blackbird,WT20,7,7,14,7,165,165,330,165
Eur. Blackbird,RT24,7,7,14,7,165,165,330,165
Eur. Blackbird,RT16,7,7,14,7,165,165,330,165
Eur. Blackbird,WT14,7,7,14,7,165,165,330,165
Eur. Blackbird,RT11,7,7,14,7,165,165,330,165
Eur. Blackbird,RT25,7,7,14,7,165,165,330,165
Eur. Blackbird,WT19,7,7,14,7,165,166,331,165.5
Eur. Blackbird,WT31,7,7,14,7,165,167,332,166
Eur. Blackbird,WT22,7,7,14,7,165,167,332,166
Eur. Blackbird,WT27,7,7,14,7,165,167,332,166
Eur. Blackbird,RT22,7,7,14,7,165,167,332,166
Eur. Blackbird,WT07,7,7,14,7,165,169,334,167
Eur. Blackbird,RT08,7,7,14,7,165,170,335,167.5
Eur. Blackbird,RT14,7,7,14,7,165,170,335,167.5
Eur. Blackbird,RT21,7,7,14,7,165,170,335,167.5
Eur. Blackbird,RT10,7,7,14,7,165,170,335,167.5
Eur. Blackbird,RT17,7,7,14,7,165,171,336,168
Eur. Blackbird,WT26,7,7,14,7,165,171,336,168
Eur. Blackbird,RT02,7,7,14,7,165,171,336,168
Eur. Blackbird,WT08,7,7,14,7,165,171,336,168
Eur. Blackbird,RT27,7,7,14,7,165,171,336,168
Eur. Blackbird,RT19,7,7,14,7,165,171,336,168
Eur. Blackbird,WT23,7,7,14,7,165,171,336,168
Eur. Blackbird,RT04,7,7,14,7,165,173,338,169
Eur. Blackbird,RT06,7,7,14,7,165,178,343,171.5
Eur. Blackbird,RT01,7,7,14,7,169,171,340,170
Eur. Blackbird,WT02,7,7,14,7,171,171,342,171
Eur. Blackbird,WT21,7,7,14,7,171,174,345,172.5
Eur. Blackbird,UT12,7,7,14,7,163,165,328,164
Eur. Blackbird,UT03,7,7,14,7,163,165,328,164
Eur. Blackbird,UT33,7,7,14,7,163,171,334,167
Eur. Blackbird,UT29,7,7,14,7,165,165,330,165
Eur. Blackbird,UT34,7,7,14,7,165,165,330,165
Eur. Blackbird,UT04,7,7,14,7,165,165,330,165
Eur. Blackbird,UT17,7,7,14,7,165,165,330,165
Eur. Blackbird,UT28,7,7,14,7,165,165,330,165
Eur. Blackbird,UT23,7,7,14,7,165,165,330,165
Eur. Blackbird,UT13,7,7,14,7,165,165,330,165
Eur. Blackbird,UT35,7,7,14,7,165,165,330,165
Eur. Blackbird,UT32,7,7,14,7,165,165,330,165
Eur. Blackbird,UT21,7,7,14,7,165,165,330,165
Eur. Blackbird,UT15,7,7,14,7,165,165,330,165
Eur. Blackbird,UT24,7,7,14,7,165,165,330,165
Eur. Blackbird,UT27,7,7,14,7,165,165,330,165
Eur. Blackbird,UT16,7,7,14,7,165,165,330,165
Eur. Blackbird,UT14,7,7,14,7,165,166,331,165.5
Eur. Blackbird,UT19,7,7,14,7,165,166,331,165.5
Eur. Blackbird,UT26,7,7,14,7,165,167,332,166
Eur. Blackbird,UT11,7,7,14,7,165,167,332,166
Eur. Blackbird,UT10,7,7,14,7,165,167,332,166
Eur. Blackbird,UT31,7,7,14,7,165,167,332,166
Eur. Blackbird,UT08,7,7,14,7,165,169,334,167
Eur. Blackbird,UT30,7,7,14,7,165,170,335,167.5
Eur. Blackbird,UT01,7,7,14,7,165,170,335,167.5
Eur. Blackbird,UT05,7,7,14,7,165,171,336,168
Eur. Blackbird,UT22,7,7,14,7,165,171,336,168
Eur. Blackbird,UT20,7,7,14,7,166,166,332,166
Eur. Blackbird,UT09,7,7,14,7,166,167,333,166.5
Eur. Blackbird,UT02,7,7,14,7,166,176,342,171
Eur. Blackbird,UT07,7,7,14,7,167,170,337,168.5
Eur. Blackbird,UT18,7,7,14,7,167,174,341,170.5
Eur. Blackbird,UT25,7,7,14,7,170,176,346,173
Eur. Blackbird,UT06,7,7,14,7,171,176,347,173.5
Eur. Blackbird,SS21,7,7,14,7,163,167,330,165
Eur. Blackbird,SS26,7,7,14,7,163,167,330,165
Eur. Blackbird,SS32,7,7,14,7,163,170,333,166.5
Eur. Blackbird,SS22,7,7,14,7,164,167,331,165.5
Eur. Blackbird,SS12,7,7,14,7,165,165,330,165
Eur. Blackbird,SS15,7,7,14,7,165,165,330,165
Eur. Blackbird,SS11,7,7,14,7,165,167,332,166
Eur. Blackbird,SS27,7,7,14,7,165,167,332,166
Eur. Blackbird,SS05,7,7,14,7,165,167,332,166
Eur. Blackbird,SS01,7,7,14,7,165,167,332,166
Eur. Blackbird,SS31,7,7,14,7,165,167,332,166
Eur. Blackbird,SS23,7,7,14,7,165,167,332,166
Eur. Blackbird,SS18,7,7,14,7,165,167,332,166
Eur. Blackbird,SS28,7,7,14,7,165,169,334,167
Eur. Blackbird,SS20,7,7,14,7,165,169,334,167
Eur. Blackbird,SS08,7,7,14,7,165,170,335,167.5
Eur. Blackbird,SS19,7,7,14,7,165,171,336,168
Eur. Blackbird,SS25,7,7,14,7,165,171,336,168
Eur. Blackbird,SS17,7,7,14,7,165,171,336,168
Eur. Blackbird,SS10,7,7,14,7,165,171,336,168
Eur. Blackbird,SS02,7,7,14,7,167,167,334,167
Eur. Blackbird,SS09,7,7,14,7,167,169,336,168
Eur. Blackbird,SS06,7,7,14,7,167,170,337,168.5
Eur. Blackbird,SS13,7,7,14,7,167,171,338,169
Eur. Blackbird,SS30,7,7,14,7,167,171,338,169
Eur. Blackbird,SS14,7,7,14,7,167,171,338,169
Eur. Blackbird,SS04,7,7,14,7,167,171,338,169
Eur. Blackbird,SS24,7,7,14,7,168,171,339,169.5
Eur. Blackbird,SS16,7,7,14,7,170,170,340,170
Eur. Blackbird,SS29,7,7,14,7,170,170,340,170
Eur. Blackbird,SS07,7,7,14,7,171,171,342,171
Eur. Blackbird,SS03,7,7,14,7,171,171,342,171
Eur. Blackbird,VS08,7,7,14,7,157,165,322,161
Eur. Blackbird,VS25,7,7,14,7,157,167,324,162
Eur. Blackbird,VS24,7,7,14,7,165,165,330,165
Eur. Blackbird,VS06,7,7,14,7,165,165,330,165
Eur. Blackbird,VS20,7,7,14,7,165,165,330,165
Eur. Blackbird,VS02,7,7,14,7,165,167,332,166
Eur. Blackbird,VS07,7,7,14,7,165,167,332,166
Eur. Blackbird,VS14,7,7,14,7,165,167,332,166
Eur. Blackbird,VS05,7,7,14,7,165,167,332,166
Eur. Blackbird,VS09,7,7,14,7,165,167,332,166
Eur. Blackbird,VS22,7,7,14,7,165,167,332,166
Eur. Blackbird,VS01,7,7,14,7,165,167,332,166
Eur. Blackbird,VS30,7,7,14,7,165,167,332,166
Eur. Blackbird,VS13,7,7,14,7,165,169,334,167
Eur. Blackbird,VS04,7,7,14,7,165,169,334,167
Eur. Blackbird,VS11,7,7,14,7,165,169,334,167
Eur. Blackbird,VS23,7,7,14,7,165,171,336,168
Eur. Blackbird,VS17,7,7,14,7,165,173,338,169
Eur. Blackbird,VS12,7,7,14,7,167,167,334,167
Eur. Blackbird,VS03,7,7,14,7,167,169,336,168
Eur. Blackbird,VS29,7,7,14,7,167,169,336,168
Eur. Blackbird,VS16,7,7,14,7,167,169,336,168
Eur. Blackbird,VS19,7,7,14,7,167,169,336,168
Eur. Blackbird,VS21,7,7,14,7,167,169,336,168
Eur. Blackbird,VS26,7,7,14,7,167,169,336,168
Eur. Blackbird,VS15,7,7,14,7,167,171,338,169
Eur. Blackbird,VS10,7,7,14,7,167,171,338,169
Eur. Blackbird,VS18,7,7,14,7,167,171,338,169
Eur. Blackbird,VS28,7,7,14,7,167,171,338,169
Eur. Blackbird,VS27,7,7,14,7,167,171,338,169
Eur. Blackbird,VS31,7,7,14,7,169,171,340,170
