Species,Sample ID,Clock 1,Clock 2,Sum,Mean ,Adcyap1,Adcyap2,Sum,Mean
Tree swallow,F001,6,8,14,7,175,181,356,178
Tree swallow,F002,8,8,16,8,174,180,354,177
Tree swallow,F003,9,9,18,9,170,178,348,174
Tree swallow,F004,9,9,18,9,171,173,344,172
Tree swallow,F005,6,8,14,7,173,175,348,174
Tree swallow,F006,8,9,17,8.5,171,174,345,172.5
Tree swallow,F007,8,9,17,8.5,172,173,345,172.5
Tree swallow,F008,8,9,17,8.5,172,177,349,174.5
Tree swallow,F009,8,8,16,8,174,176,350,175
Tree swallow,F010,7,8,15,7.5,170,179,349,174.5
Tree swallow,F011,8,9,17,8.5,173,174,347,173.5
Tree swallow,F012,8,9,17,8.5,174,176,350,175
Tree swallow,F013,9,9,18,9,181,182,363,181.5
Tree swallow,F014,8,8,16,8,176,185,361,180.5
Tree swallow,F015,8,9,17,8.5,175,178,353,176.5
Tree swallow,F016,8,9,17,8.5,173,178,351,175.5
Tree swallow,F017,7,9,16,8,172,178,350,175
Tree swallow,F018,7,9,16,8,175,178,353,176.5
Tree swallow,F019,8,9,17,8.5,173,173,346,173
Tree swallow,F020,8,9,17,8.5,176,181,357,178.5
Tree swallow,F021,7,8,15,7.5,173,178,351,175.5
Tree swallow,F022,6,8,14,7,171,183,354,177
Tree swallow,F023,7,8,15,7.5,171,172,343,171.5
Tree swallow,F024,8,9,17,8.5,172,175,347,173.5
Tree swallow,F025,8,8,16,8,174,178,352,176
Tree swallow,F026,8,8,16,8,177,177,354,177
Tree swallow,F027,8,8,16,8,172,177,349,174.5
Tree swallow,F028,8,9,17,8.5,171,174,345,172.5
Tree swallow,F029,8,9,17,8.5,174,176,350,175
Tree swallow,F030,8,8,16,8,168,175,343,171.5
Tree swallow,F031,8,8,16,8,173,176,349,174.5
Tree swallow,F032,9,9,18,9,174,176,350,175
Tree swallow,F033,9,9,18,9,172,181,353,176.5
Tree swallow,F034,8,8,16,8,172,181,353,176.5
Tree swallow,F035,8,9,17,8.5,174,180,354,177
Tree swallow,F036,8,8,16,8,174,175,349,174.5
Tree swallow,F037,8,9,17,8.5,173,176,349,174.5
Tree swallow,F038,8,9,17,8.5,172,175,347,173.5
Tree swallow,F039,8,8,16,8,172,174,346,173
Tree swallow,F040,8,8,16,8,174,176,350,175
Tree swallow,F041,8,9,17,8.5,171,173,344,172
Tree swallow,F042,8,8,16,8,172,178,350,175
Tree swallow,F043,8,8,16,8,181,181,362,181
Tree swallow,F044,8,8,16,8,173,175,348,174
Tree swallow,F045,8,8,16,8,172,183,355,177.5
Tree swallow,F046,8,9,17,8.5,176,180,356,178
Tree swallow,F047,8,8,16,8,174,176,350,175
Tree swallow,F048,8,8,16,8,173,177,350,175
Tree swallow,F049,8,8,16,8,176,176,352,176
Tree swallow,F050,7,9,16,8,170,177,347,173.5
Tree swallow,F051,7,9,16,8,170,177,347,173.5
Tree swallow,F052,8,8,16,8,176,181,357,178.5
Tree swallow,F053,9,9,18,9,172,174,346,173
Tree swallow,F054,8,9,17,8.5,175,178,353,176.5
Tree swallow,F055,8,9,17,8.5,174,175,349,174.5
Tree swallow,F056,6,8,14,7,174,176,350,175
Tree swallow,F057,8,8,16,8,175,176,351,175.5
Tree swallow,F058,8,8,16,8,172,173,345,172.5
Tree swallow,F059,8,9,17,8.5,172,176,348,174
Tree swallow,F060,8,9,17,8.5,171,175,346,173
Tree swallow,F061,8,8,16,8,173,173,346,173
Tree swallow,F062,8,9,17,8.5,175,180,355,177.5
Tree swallow,F063,6,9,15,7.5,170,172,342,171
Tree swallow,F064,8,8,16,8,176,180,356,178
Tree swallow,F065,8,8,16,8,173,178,351,175.5
Tree swallow,F066,6,8,14,7,177,185,362,181
Tree swallow,F067,8,9,17,8.5,172,174,346,173
Tree swallow,F068,8,9,17,8.5,170,173,343,171.5
Tree swallow,F069,8,9,17,8.5,170,172,342,171
Tree swallow,F070,8,8,16,8,172,176,348,174
Tree swallow,F071,8,9,17,8.5,174,178,352,176
Tree swallow,F072,8,9,17,8.5,173,176,349,174.5
Tree swallow,F073,8,8,16,8,175,175,350,175
Tree swallow,F074,9,9,18,9,175,176,351,175.5
Tree swallow,F075,8,9,17,8.5,172,177,349,174.5
Tree swallow,F076,8,9,17,8.5,170,174,344,172
Tree swallow,F077,6,9,15,7.5,174,178,352,176
Tree swallow,F078,9,9,18,9,172,174,346,173
Tree swallow,F079,8,8,16,8,173,176,349,174.5
Tree swallow,F080,8,9,17,8.5,170,173,343,171.5
Tree swallow,F081,9,9,18,9,173,180,353,176.5
Tree swallow,F082,8,8,16,8,174,175,349,174.5
Tree swallow,F083,8,9,17,8.5,170,176,346,173
Tree swallow,F084,7,8,15,7.5,173,178,351,175.5
Tree swallow,F085,8,9,17,8.5,168,174,342,171
Tree swallow,F086,8,9,17,8.5,174,182,356,178
Tree swallow,F087,8,9,17,8.5,171,174,345,172.5
Tree swallow,F088,9,9,18,9,172,176,348,174
Tree swallow,F089,9,9,18,9,174,175,349,174.5
Tree swallow,F090,8,9,17,8.5,173,176,349,174.5
Tree swallow,F091,8,9,17,8.5,174,183,357,178.5
Tree swallow,F092,6,8,14,7,173,181,354,177
Tree swallow,F093,8,8,16,8,171,173,344,172
Tree swallow,F094,6,9,15,7.5,172,177,349,174.5
Tree swallow,F095,9,9,18,9,175,176,351,175.5
Tree swallow,F096,8,8,16,8,172,173,345,172.5
Tree swallow,F097,8,9,17,8.5,170,175,345,172.5
Tree swallow,F098,8,9,17,8.5,175,183,358,179
Tree swallow,F099,8,9,17,8.5,170,174,344,172
Tree swallow,F100,8,8,16,8,173,178,351,175.5
Tree swallow,F101,8,8,16,8,171,173,344,172
Tree swallow,F102,8,8,16,8,176,182,358,179
Tree swallow,F103,9,9,18,9,171,183,354,177
Tree swallow,F104,8,8,16,8,177,178,355,177.5
Tree swallow,F105,8,9,17,8.5,172,189,361,180.5
Tree swallow,F106,8,8,16,8,176,178,354,177
Tree swallow,F107,8,8,16,8,172,174,346,173
Tree swallow,F108,8,9,17,8.5,173,185,358,179
Tree swallow,F109,8,9,17,8.5,173,173,346,173
Tree swallow,F110,6,9,15,7.5,169,172,341,170.5
Tree swallow,F111,8,8,16,8,165,172,337,168.5
Tree swallow,F112,8,9,17,8.5,173,178,351,175.5
Tree swallow,F113,8,8,16,8,175,184,359,179.5
Tree swallow,F114,9,9,18,9,174,178,352,176
Tree swallow,F115,8,9,17,8.5,178,178,356,178
Tree swallow,F116,6,8,14,7,177,184,361,180.5
Tree swallow,F117,8,8,16,8,178,183,361,180.5
Tree swallow,F118,8,8,16,8,176,178,354,177
Tree swallow,F119,8,8,16,8,176,179,355,177.5
Tree swallow,F120,8,8,16,8,176,180,356,178
Tree swallow,F121,8,8,16,8,177,178,355,177.5
Tree swallow,F122,8,9,17,8.5,170,176,346,173
Tree swallow,F123,8,9,17,8.5,178,183,361,180.5
Tree swallow,F124,9,9,18,9,174,178,352,176
Tree swallow,F125,8,8,16,8,174,174,348,174
Tree swallow,F126,8,9,17,8.5,172,174,346,173
Tree swallow,F127,8,9,17,8.5,170,174,344,172
Tree swallow,F128,8,9,17,8.5,172,175,347,173.5
Tree swallow,F129,9,9,18,9,171,176,347,173.5
Tree swallow,F130,8,9,17,8.5,174,174,348,174
Tree swallow,F131,6,8,14,7,178,180,358,179
Tree swallow,F132,8,8,16,8,172,179,351,175.5
Tree swallow,F133,8,8,16,8,172,180,352,176
Tree swallow,F134,8,9,17,8.5,168,181,349,174.5
Tree swallow,F135,8,8,16,8,180,185,365,182.5
Tree swallow,F136,8,9,17,8.5,174,174,348,174
Tree swallow,F137,8,9,17,8.5,173,173,346,173
Tree swallow,F138,8,8,16,8,173,174,347,173.5
Tree swallow,F139,8,9,17,8.5,173,176,349,174.5
Tree swallow,F140,9,9,18,9,171,173,344,172
Tree swallow,F141,6,8,14,7,175,178,353,176.5
Tree swallow,F142,9,9,18,9,173,179,352,176
Tree swallow,F143,7,8,15,7.5,173,176,349,174.5
Tree swallow,F144,6,8,14,7,172,176,348,174
Tree swallow,F145,8,9,17,8.5,167,178,345,172.5
Tree swallow,F146,9,9,18,9,173,173,346,173
Tree swallow,F147,8,9,17,8.5,172,173,345,172.5
Tree swallow,F148,8,8,16,8,174,178,352,176
Tree swallow,F149,8,9,17,8.5,168,172,340,170
Tree swallow,F150,8,9,17,8.5,173,178,351,175.5
Tree swallow,F151,9,9,18,9,175,183,358,179
Tree swallow,F152,8,9,17,8.5,175,180,355,177.5
Tree swallow,F153,8,9,17,8.5,183,184,367,183.5
Tree swallow,F154,8,8,16,8,172,174,346,173
Tree swallow,F155,8,9,17,8.5,174,174,348,174
Tree swallow,F156,8,9,17,8.5,173,173,346,173
Tree swallow,F157,8,9,17,8.5,173,174,347,173.5
Tree swallow,F158,9,9,18,9,175,179,354,177
Tree swallow,F159,8,9,17,8.5,173,178,351,175.5
Tree swallow,F160,8,8,16,8,173,176,349,174.5
Tree swallow,F161,8,9,17,8.5,172,180,352,176
Tree swallow,F162,8,9,17,8.5,179,179,358,179
Tree swallow,F163,6,8,14,7,176,178,354,177
Tree swallow,F164,8,9,17,8.5,175,175,350,175
Tree swallow,F165,8,9,17,8.5,166,173,339,169.5
Tree swallow,F166,8,9,17,8.5,166,178,344,172
Tree swallow,F167,8,9,17,8.5,177,178,355,177.5
Tree swallow,F168,8,8,16,8,174,179,353,176.5
Tree swallow,F169,8,9,17,8.5,174,178,352,176
Tree swallow,F170,8,8,16,8,170,179,349,174.5
Tree swallow,F171,8,8,16,8,175,179,354,177
Tree swallow,F172,8,8,16,8,176,181,357,178.5
Tree swallow,F173,8,8,16,8,178,178,356,178
Tree swallow,F174,8,8,16,8,173,179,352,176
Tree swallow,F175,8,8,16,8,180,181,361,180.5
Tree swallow,F176,8,9,17,8.5,176,178,354,177
Tree swallow,F177,8,8,16,8,172,177,349,174.5
Tree swallow,F178,8,9,17,8.5,178,183,361,180.5
Tree swallow,F179,9,9,18,9,178,182,360,180
Tree swallow,F180,8,9,17,8.5,170,174,344,172
Tree swallow,F181,9,9,18,9,175,176,351,175.5
Tree swallow,F182,8,8,16,8,178,186,364,182
Tree swallow,F183,8,8,16,8,174,182,356,178
Tree swallow,F184,7,8,15,7.5,175,178,353,176.5
Tree swallow,F185,8,8,16,8,172,173,345,172.5
Tree swallow,F186,7,8,15,7.5,177,181,358,179
Tree swallow,F187,8,8,16,8,173,175,348,174
Tree swallow,F188,8,9,17,8.5,174,180,354,177
Tree swallow,F189,8,8,16,8,177,183,360,180
Tree swallow,F190,8,9,17,8.5,173,176,349,174.5
Tree swallow,F191,8,8,16,8,178,178,356,178
Tree swallow,F192,6,8,14,7,173,178,351,175.5
Tree swallow,F193,8,9,17,8.5,171,173,344,172
Tree swallow,F194,8,8,16,8,174,176,350,175
Tree swallow,F195,8,8,16,8,177,180,357,178.5
Tree swallow,F196,8,8,16,8,170,176,346,173
Tree swallow,F197,8,8,16,8,177,179,356,178
Tree swallow,F198,9,9,18,9,173,179,352,176
Tree swallow,F199,8,9,17,8.5,172,176,348,174
Tree swallow,F200,8,8,16,8,173,176,349,174.5
Tree swallow,F201,8,8,16,8,176,178,354,177
Tree swallow,F202,8,9,17,8.5,176,179,355,177.5
Tree swallow,F203,8,9,17,8.5,166,173,339,169.5
Tree swallow,F204,9,9,18,9,173,173,346,173
Tree swallow,F205,8,8,16,8,172,176,348,174
Tree swallow,F206,8,8,16,8,172,178,350,175
Tree swallow,F207,8,9,17,8.5,171,174,345,172.5
Tree swallow,F208,8,8,16,8,180,186,366,183
Tree swallow,F209,8,8,16,8,176,179,355,177.5
Tree swallow,F210,8,9,17,8.5,173,173,346,173
Tree swallow,F211,8,8,16,8,173,178,351,175.5
Tree swallow,F212,6,8,14,7,172,174,346,173
Tree swallow,F213,8,9,17,8.5,173,185,358,179
Tree swallow,F214,8,8,16,8,178,183,361,180.5
Tree swallow,F215,8,9,17,8.5,174,176,350,175
Tree swallow,F216,8,8,16,8,174,178,352,176
Tree swallow,F217,8,9,17,8.5,172,182,354,177
Tree swallow,F218,8,8,16,8,171,178,349,174.5
Tree swallow,F219,8,9,17,8.5,173,174,347,173.5
Tree swallow,F220,8,9,17,8.5,174,178,352,176
Tree swallow,F221,8,8,16,8,166,172,338,169
Tree swallow,F222,6,8,14,7,172,174,346,173
Tree swallow,F223,8,9,17,8.5,174,176,350,175
Tree swallow,F224,9,9,18,9,173,176,349,174.5
Tree swallow,F225,8,9,17,8.5,173,174,347,173.5
Tree swallow,F226,8,9,17,8.5,180,183,363,181.5
Tree swallow,F227,8,9,17,8.5,172,174,346,173
Tree swallow,F228,8,8,16,8,172,179,351,175.5
Tree swallow,F229,8,8,16,8,173,176,349,174.5
Tree swallow,F230,8,8,16,8,174,175,349,174.5
Tree swallow,F231,8,8,16,8,173,178,351,175.5
Tree swallow,F232,7,9,16,8,171,174,345,172.5
Tree swallow,F233,8,9,17,8.5,174,176,350,175
Tree swallow,F234,6,8,14,7,174,179,353,176.5
Tree swallow,F235,8,8,16,8,175,176,351,175.5
Tree swallow,F236,8,8,16,8,174,176,350,175
Tree swallow,F237,8,8,16,8,172,180,352,176
Tree swallow,F238,8,8,16,8,172,179,351,175.5
Tree swallow,F239,6,8,14,7,170,178,348,174
Tree swallow,F240,8,8,16,8,173,179,352,176
Tree swallow,F241,8,8,16,8,175,176,351,175.5
Tree swallow,F242,8,9,17,8.5,173,180,353,176.5
Tree swallow,F243,8,8,16,8,175,176,351,175.5
Tree swallow,F244,8,8,16,8,170,174,344,172
Tree swallow,F245,9,9,18,9,178,182,360,180
Tree swallow,F246,8,8,16,8,174,186,360,180
Tree swallow,F247,8,9,17,8.5,177,177,354,177
Tree swallow,F248,9,9,18,9,172,173,345,172.5
Tree swallow,F249,8,8,16,8,177,179,356,178
Tree swallow,F250,8,9,17,8.5,175,179,354,177
Tree swallow,F251,8,8,16,8,175,178,353,176.5
Tree swallow,F252,6,8,14,7,176,178,354,177
Tree swallow,F253,8,8,16,8,173,178,351,175.5
Tree swallow,F254,8,9,17,8.5,172,172,344,172
Tree swallow,F255,9,9,18,9,175,179,354,177
Tree swallow,F256,8,9,17,8.5,174,175,349,174.5
Tree swallow,F257,8,9,17,8.5,171,175,346,173
Tree swallow,F258,8,8,16,8,173,176,349,174.5
Tree swallow,F259,8,9,17,8.5,173,178,351,175.5
Tree swallow,F260,8,9,17,8.5,174,175,349,174.5
Tree swallow,F261,8,8,16,8,174,177,351,175.5
Tree swallow,F262,7,8,15,7.5,176,176,352,176
Tree swallow,F263,8,8,16,8,175,178,353,176.5
Tree swallow,F264,8,8,16,8,178,178,356,178
Tree swallow,F265,6,8,14,7,175,180,355,177.5
Tree swallow,F266,8,8,16,8,173,174,347,173.5
Tree swallow,F267,8,9,17,8.5,169,178,347,173.5
Tree swallow,F268,8,8,16,8,174,174,348,174
Tree swallow,F269,8,9,17,8.5,175,181,356,178
Tree swallow,F270,8,8,16,8,175,181,356,178
Tree swallow,F271,8,9,17,8.5,177,180,357,178.5
Tree swallow,F272,8,9,17,8.5,173,176,349,174.5
Tree swallow,F273,8,8,16,8,174,178,352,176
Tree swallow,F274,8,9,17,8.5,172,173,345,172.5
Tree swallow,F275,8,8,16,8,176,177,353,176.5
Tree swallow,F276,8,9,17,8.5,170,179,349,174.5
Tree swallow,F277,8,9,17,8.5,177,181,358,179
Tree swallow,F278,8,9,17,8.5,174,189,363,181.5
Tree swallow,F279,8,9,17,8.5,173,174,347,173.5
Tree swallow,F280,8,9,17,8.5,176,181,357,178.5
Tree swallow,F281,8,8,16,8,171,176,347,173.5
Tree swallow,F282,8,8,16,8,173,173,346,173
Tree swallow,F283,8,8,16,8,176,178,354,177
Tree swallow,F284,8,8,16,8,175,180,355,177.5
Tree swallow,F285,8,9,17,8.5,175,183,358,179
Tree swallow,F286,9,9,18,9,173,173,346,173
Tree swallow,F287,8,9,17,8.5,176,177,353,176.5
Tree swallow,F288,8,8,16,8,172,185,357,178.5
Tree swallow,F289,8,8,16,8,172,175,347,173.5
Tree swallow,F290,9,9,18,9,172,173,345,172.5
Tree swallow,F291,8,9,17,8.5,173,176,349,174.5
Tree swallow,F292,8,8,16,8,172,176,348,174
Tree swallow,F293,6,7,13,6.5,174,174,348,174
Tree swallow,F294,8,8,16,8,175,183,358,179
Tree swallow,F295,8,9,17,8.5,173,174,347,173.5
Tree swallow,F296,8,8,16,8,172,172,344,172
Tree swallow,F297,9,9,18,9,181,189,370,185
Tree swallow,F298,8,8,16,8,174,178,352,176
Tree swallow,F299,9,9,18,9,172,177,349,174.5
Tree swallow,F300,8,8,16,8,173,176,349,174.5
Tree swallow,F301,9,9,18,9,175,178,353,176.5
Tree swallow,F302,8,8,16,8,172,182,354,177
Tree swallow,F304,8,9,17,8.5,171,178,349,174.5
Tree swallow,F305,8,8,16,8,172,180,352,176
Tree swallow,F306,8,9,17,8.5,170,175,345,172.5
Tree swallow,F307,8,8,16,8,174,176,350,175
Tree swallow,F308,8,8,16,8,172,174,346,173
Tree swallow,F309,8,9,17,8.5,172,173,345,172.5
Tree swallow,F310,8,8,16,8,175,176,351,175.5
Tree swallow,F311,8,9,17,8.5,171,178,349,174.5
Tree swallow,F312,8,9,17,8.5,172,178,350,175
Tree swallow,F313,7,8,15,7.5,175,176,351,175.5
Tree swallow,F314,8,8,16,8,178,179,357,178.5
Tree swallow,F315,7,8,15,7.5,170,173,343,171.5
Tree swallow,F316,8,9,17,8.5,174,174,348,174
Tree swallow,F317,8,8,16,8,173,175,348,174
Tree swallow,F318,7,8,15,7.5,172,172,344,172
Tree swallow,F319,8,9,17,8.5,175,178,353,176.5
Tree swallow,F320,6,8,14,7,175,183,358,179
Tree swallow,F321,8,9,17,8.5,173,174,347,173.5
Tree swallow,F322,8,9,17,8.5,173,174,347,173.5
Tree swallow,F323,8,8,16,8,172,178,350,175
Tree swallow,F324,8,8,16,8,175,177,352,176
Tree swallow,F325,8,9,17,8.5,172,173,345,172.5
Tree swallow,F326,8,9,17,8.5,178,183,361,180.5
Tree swallow,F327,8,8,16,8,172,174,346,173
Tree swallow,F328,9,9,18,9,173,182,355,177.5
Tree swallow,F329,9,9,18,9,170,176,346,173
Tree swallow,F330,8,8,16,8,172,181,353,176.5
Tree swallow,F331,8,9,17,8.5,179,182,361,180.5
Tree swallow,F332,8,8,16,8,175,175,350,175
Tree swallow,F333,8,8,16,8,176,184,360,180
Tree swallow,F334,9,9,18,9,175,177,352,176
Tree swallow,F335,8,8,16,8,173,176,349,174.5
Tree swallow,F336,8,9,17,8.5,173,178,351,175.5
Tree swallow,F337,8,8,16,8,174,176,350,175
Tree swallow,F338,9,9,18,9,173,173,346,173
Tree swallow,F339,8,9,17,8.5,174,186,360,180
Tree swallow,F340,8,9,17,8.5,169,177,346,173
Tree swallow,F341,7,8,15,7.5,173,174,347,173.5
Tree swallow,F343,8,9,17,8.5,173,180,353,176.5
Tree swallow,F344,7,8,15,7.5,170,176,346,173
Tree swallow,F345,8,8,16,8,174,174,348,174
Tree swallow,F346,8,9,17,8.5,175,181,356,178
Tree swallow,F347,8,8,16,8,171,175,346,173
Tree swallow,F348,8,9,17,8.5,174,178,352,176
Tree swallow,F349,7,8,15,7.5,173,176,349,174.5
Tree swallow,F350,8,9,17,8.5,178,179,357,178.5
Tree swallow,F351,7,8,15,7.5,176,178,354,177
Tree swallow,F352,8,8,16,8,173,175,348,174
Tree swallow,F353,8,9,17,8.5,176,177,353,176.5
Tree swallow,F354,8,8,16,8,174,175,349,174.5
Tree swallow,F355,8,9,17,8.5,176,178,354,177
Tree swallow,F356,8,9,17,8.5,173,175,348,174
Tree swallow,F357,7,8,15,7.5,173,174,347,173.5
Tree swallow,F358,7,9,16,8,173,174,347,173.5
Tree swallow,F359,8,8,16,8,174,179,353,176.5
Tree swallow,F360,8,9,17,8.5,173,174,347,173.5
Tree swallow,F361,7,9,16,8,181,181,362,181
Tree swallow,F362,9,9,18,9,172,178,350,175
Tree swallow,F363,9,9,18,9,184,189,373,186.5
Tree swallow,F364,8,8,16,8,176,178,354,177
Tree swallow,F365,8,9,17,8.5,173,178,351,175.5
Tree swallow,F366,8,9,17,8.5,177,178,355,177.5
Tree swallow,F367,8,8,16,8,174,175,349,174.5
Tree swallow,F368,8,9,17,8.5,176,177,353,176.5
Tree swallow,F369,8,8,16,8,172,174,346,173
Tree swallow,F370,8,9,17,8.5,175,178,353,176.5
Tree swallow,F371,9,9,18,9,172,179,351,175.5
Tree swallow,F372,8,8,16,8,172,175,347,173.5
Tree swallow,F373,8,9,17,8.5,172,175,347,173.5
Tree swallow,F374,8,9,17,8.5,173,176,349,174.5
Tree swallow,F375,8,8,16,8,173,178,351,175.5
Tree swallow,F376,8,9,17,8.5,170,178,348,174
Tree swallow,F377,9,9,18,9,170,174,344,172
Tree swallow,F378,8,9,17,8.5,174,178,352,176
Tree swallow,F379,7,8,15,7.5,174,174,348,174
Tree swallow,F380,8,8,16,8,173,176,349,174.5
Tree swallow,F381,8,9,17,8.5,172,173,345,172.5
Tree swallow,F382,8,9,17,8.5,172,173,345,172.5
Tree swallow,F383,8,9,17,8.5,172,173,345,172.5
Tree swallow,F384,8,8,16,8,174,174,348,174
Tree swallow,F385,8,8,16,8,175,178,353,176.5
Tree swallow,F386,6,8,14,7,172,173,345,172.5
Tree swallow,F387,8,9,17,8.5,173,176,349,174.5
Tree swallow,F388,9,9,18,9,175,176,351,175.5
Tree swallow,F389,9,9,18,9,175,178,353,176.5
Tree swallow,F390,8,9,17,8.5,176,181,357,178.5
Tree swallow,F391,9,9,18,9,173,178,351,175.5
Tree swallow,F392,8,8,16,8,178,179,357,178.5
Tree swallow,F393,9,9,18,9,172,174,346,173
Tree swallow,F394,8,9,17,8.5,172,175,347,173.5
Tree swallow,F395,8,8,16,8,173,176,349,174.5
Tree swallow,F396,8,8,16,8,173,178,351,175.5
Tree swallow,F397,8,8,16,8,172,173,345,172.5
Tree swallow,F398,8,8,16,8,172,173,345,172.5
Tree swallow,F399,8,9,17,8.5,171,175,346,173
Tree swallow,F400,8,9,17,8.5,NA,NA,NA,NA
Tree swallow,F401,9,9,18,9,166,177,343,171.5
Tree swallow,F402,8,9,17,8.5,173,176,349,174.5
Tree swallow,F403,7,9,16,8,175,176,351,175.5
Tree swallow,F404,9,9,18,9,175,178,353,176.5
Tree swallow,F405,8,9,17,8.5,173,182,355,177.5
Tree swallow,F406,7,8,15,7.5,173,178,351,175.5
Tree swallow,F407,8,8,16,8,174,174,348,174
Tree swallow,F408,8,8,16,8,173,177,350,175
Tree swallow,F409,8,9,17,8.5,172,174,346,173
Tree swallow,F410,8,9,17,8.5,172,180,352,176
Tree swallow,F411,8,9,17,8.5,176,183,359,179.5
Tree swallow,F412,8,8,16,8,176,178,354,177
Tree swallow,F413,8,9,17,8.5,172,179,351,175.5
Tree swallow,F414,6,9,15,7.5,176,181,357,178.5
Tree swallow,F415,8,8,16,8,176,180,356,178
Tree swallow,F416,8,9,17,8.5,166,172,338,169
Tree swallow,F417,8,8,16,8,170,175,345,172.5
Tree swallow,F418,8,9,17,8.5,172,179,351,175.5
Tree swallow,F419,8,8,16,8,172,175,347,173.5
Tree swallow,F420,8,9,17,8.5,178,189,367,183.5
Tree swallow,F421,9,9,18,9,176,177,353,176.5
Tree swallow,F422,8,9,17,8.5,172,176,348,174
Tree swallow,F423,8,9,17,8.5,171,181,352,176
Tree swallow,F424,8,9,17,8.5,174,176,350,175
Tree swallow,F425,8,8,16,8,178,178,356,178
Tree swallow,F426,8,9,17,8.5,177,183,360,180
Tree swallow,F427,9,9,18,9,173,183,356,178
Tree swallow,F428,8,9,17,8.5,173,176,349,174.5
Tree swallow,F429,8,8,16,8,178,181,359,179.5
Tree swallow,F430,9,9,18,9,172,178,350,175
Tree swallow,F431,8,8,16,8,176,181,357,178.5
Tree swallow,F432,8,8,16,8,174,180,354,177
Tree swallow,F433,9,9,18,9,173,180,353,176.5
Tree swallow,F434,9,9,18,9,173,175,348,174
Tree swallow,F435,8,9,17,8.5,170,175,345,172.5
Tree swallow,F436,8,9,17,8.5,175,186,361,180.5
Tree swallow,F437,8,9,17,8.5,173,174,347,173.5
Tree swallow,F438,8,8,16,8,174,174,348,174
Tree swallow,F439,8,9,17,8.5,174,174,348,174
Tree swallow,F440,8,8,16,8,168,172,340,170
Tree swallow,F441,8,9,17,8.5,173,178,351,175.5
Tree swallow,F442,8,9,17,8.5,170,174,344,172
Tree swallow,F443,9,9,18,9,170,177,347,173.5
Tree swallow,F444,8,9,17,8.5,166,174,340,170
Tree swallow,F445,8,9,17,8.5,180,182,362,181
Tree swallow,F446,8,8,16,8,170,181,351,175.5
Tree swallow,F447,8,8,16,8,174,185,359,179.5
Tree swallow,F448,9,9,18,9,174,180,354,177
Tree swallow,F449,8,9,17,8.5,174,179,353,176.5
Tree swallow,F450,8,9,17,8.5,172,173,345,172.5
Tree swallow,F451,8,9,17,8.5,174,179,353,176.5
Tree swallow,F452,8,8,16,8,173,186,359,179.5
Tree swallow,F453,8,8,16,8,176,178,354,177
Tree swallow,F454,8,8,16,8,172,179,351,175.5
Tree swallow,F455,8,9,17,8.5,181,181,362,181
Tree swallow,F456,8,8,16,8,172,183,355,177.5
Tree swallow,F457,8,9,17,8.5,174,176,350,175
Tree swallow,F458,8,9,17,8.5,178,182,360,180
Tree swallow,F459,8,9,17,8.5,175,178,353,176.5
Tree swallow,F460,7,8,15,7.5,172,176,348,174
Tree swallow,F461,9,9,18,9,174,178,352,176
Tree swallow,F462,8,8,16,8,176,189,365,182.5
Tree swallow,F463,8,8,16,8,168,178,346,173
Tree swallow,F464,7,8,15,7.5,179,180,359,179.5
Tree swallow,F465,9,9,18,9,176,177,353,176.5
Tree swallow,F466,8,8,16,8,175,181,356,178
Tree swallow,F467,8,8,16,8,174,178,352,176
Tree swallow,F468,8,9,17,8.5,172,176,348,174
Tree swallow,F469,8,8,16,8,170,181,351,175.5
Tree swallow,F470,8,9,17,8.5,173,175,348,174
Tree swallow,F471,8,8,16,8,172,176,348,174
Tree swallow,F472,8,9,17,8.5,172,174,346,173
Tree swallow,F473,8,9,17,8.5,176,180,356,178
Tree swallow,F474,8,9,17,8.5,172,178,350,175
Tree swallow,F475,9,9,18,9,175,178,353,176.5
Tree swallow,F476,8,8,16,8,170,174,344,172
Tree swallow,F477,8,8,16,8,172,176,348,174
Tree swallow,F478,8,9,17,8.5,174,176,350,175
Tree swallow,F479,8,8,16,8,177,177,354,177
Tree swallow,F480,8,8,16,8,172,173,345,172.5
Tree swallow,F481,9,9,18,9,175,176,351,175.5
Tree swallow,F482,8,9,17,8.5,176,180,356,178
Tree swallow,F483,8,9,17,8.5,172,176,348,174
Tree swallow,F484,8,8,16,8,180,180,360,180
Tree swallow,F485,9,9,18,9,173,181,354,177
Tree swallow,F486,8,9,17,8.5,174,176,350,175
Tree swallow,F487,8,8,16,8,174,174,348,174
Tree swallow,F488,8,9,17,8.5,175,183,358,179
Tree swallow,F489,8,8,16,8,172,175,347,173.5
Tree swallow,F490,8,9,17,8.5,176,178,354,177
Tree swallow,F491,8,9,17,8.5,173,176,349,174.5
Tree swallow,F492,8,8,16,8,178,182,360,180
Tree swallow,F493,8,8,16,8,176,177,353,176.5
Tree swallow,F494,7,8,15,7.5,176,187,363,181.5
Tree swallow,F495,8,8,16,8,178,181,359,179.5
Tree swallow,F496,6,9,15,7.5,172,180,352,176
Tree swallow,F497,8,8,16,8,178,179,357,178.5
Tree swallow,F498,8,9,17,8.5,172,178,350,175
Tree swallow,F499,9,9,18,9,NA,NA,NA,NA
Tree swallow,F500,8,8,16,8,174,180,354,177
Tree swallow,F501,8,9,17,8.5,173,180,353,176.5
Tree swallow,F502,8,9,17,8.5,173,176,349,174.5
Tree swallow,F503,8,9,17,8.5,173,178,351,175.5
Tree swallow,F504,7,9,16,8,175,184,359,179.5
Tree swallow,F505,8,8,16,8,172,172,344,172
Tree swallow,F506,8,9,17,8.5,173,174,347,173.5
Tree swallow,F507,8,8,16,8,NA,NA,NA,NA
Tree swallow,F508,8,8,16,8,NA,NA,NA,NA
Tree swallow,F509,8,8,16,8,173,179,352,176
Tree swallow,F510,8,9,17,8.5,171,173,344,172
Tree swallow,F511,9,9,18,9,173,178,351,175.5
Tree swallow,F512,8,8,16,8,172,179,351,175.5
Tree swallow,F513,8,9,17,8.5,174,176,350,175
Tree swallow,F514,8,8,16,8,NA,NA,NA,NA
Tree swallow,F515,8,8,16,8,174,183,357,178.5
Tree swallow,F516,8,8,16,8,173,174,347,173.5
Tree swallow,F517,8,8,16,8,NA,NA,NA,NA
Tree swallow,F518,6,8,14,7,NA,NA,NA,NA
Tree swallow,F519,8,9,17,8.5,174,174,348,174
Tree swallow,F520,8,9,17,8.5,168,174,342,171
Tree swallow,F521,8,9,17,8.5,173,181,354,177
Tree swallow,F522,8,9,17,8.5,174,179,353,176.5
Tree swallow,F523,8,9,17,8.5,174,182,356,178
Tree swallow,F524,8,9,17,8.5,178,180,358,179
Tree swallow,F525,8,9,17,8.5,175,182,357,178.5
Tree swallow,F526,8,9,17,8.5,174,174,348,174
Tree swallow,F527,8,9,17,8.5,174,179,353,176.5
Tree swallow,F528,8,8,16,8,174,178,352,176
Tree swallow,F529,8,9,17,8.5,174,176,350,175
Tree swallow,F530,8,8,16,8,170,180,350,175
Tree swallow,F531,8,9,17,8.5,172,186,358,179
Tree swallow,F532,8,9,17,8.5,174,175,349,174.5
Tree swallow,F533,8,9,17,8.5,173,173,346,173
Tree swallow,F534,8,9,17,8.5,172,173,345,172.5
Tree swallow,F535,9,9,18,9,178,179,357,178.5
Tree swallow,F536,8,8,16,8,170,182,352,176
Tree swallow,F537,8,8,16,8,172,180,352,176
Tree swallow,F538,8,9,17,8.5,166,172,338,169
Tree swallow,F539,8,9,17,8.5,174,176,350,175
Tree swallow,F540,8,9,17,8.5,172,177,349,174.5
Tree swallow,F541,8,9,17,8.5,177,177,354,177
Tree swallow,F542,8,8,16,8,174,178,352,176
Tree swallow,F543,9,9,18,9,174,174,348,174
Tree swallow,F544,8,9,17,8.5,178,189,367,183.5
Tree swallow,F545,8,8,16,8,170,174,344,172
Tree swallow,F546,8,8,16,8,173,181,354,177
Tree swallow,F547,8,9,17,8.5,175,176,351,175.5
Tree swallow,F548,8,9,17,8.5,173,173,346,173
Tree swallow,F549,8,8,16,8,174,174,348,174
Tree swallow,F550,8,8,16,8,168,173,341,170.5
Tree swallow,F551,8,9,17,8.5,173,174,347,173.5
Tree swallow,F552,8,9,17,8.5,175,177,352,176
Tree swallow,F553,6,9,15,7.5,170,181,351,175.5
Tree swallow,F554,9,9,18,9,166,172,338,169
Tree swallow,M001,8,9,17,8.5,170,179,349,174.5
Tree swallow,M002,8,8,16,8,170,174,344,172
Tree swallow,M003,9,9,18,9,176,185,361,180.5
Tree swallow,M004,8,8,16,8,174,185,359,179.5
Tree swallow,M005,8,9,17,8.5,176,177,353,176.5
Tree swallow,M006,8,9,17,8.5,173,186,359,179.5
Tree swallow,M007,8,9,17,8.5,173,176,349,174.5
Tree swallow,M008,8,9,17,8.5,173,180,353,176.5
Tree swallow,M009,8,9,17,8.5,172,174,346,173
Tree swallow,M010,7,8,15,7.5,173,174,347,173.5
Tree swallow,M011,7,8,15,7.5,174,174,348,174
Tree swallow,M012,9,9,18,9,172,179,351,175.5
Tree swallow,M013,9,9,18,9,170,176,346,173
Tree swallow,M014,8,9,17,8.5,174,178,352,176
Tree swallow,M015,8,9,17,8.5,172,181,353,176.5
Tree swallow,M016,8,8,16,8,170,174,344,172
Tree swallow,M017,8,8,16,8,170,175,345,172.5
Tree swallow,M018,8,9,17,8.5,173,179,352,176
Tree swallow,M019,8,8,16,8,176,178,354,177
Tree swallow,M020,8,9,17,8.5,173,174,347,173.5
Tree swallow,M021,8,8,16,8,170,174,344,172
Tree swallow,M022,8,8,16,8,172,175,347,173.5
Tree swallow,M023,8,9,17,8.5,168,178,346,173
Tree swallow,M024,8,9,17,8.5,176,178,354,177
Tree swallow,M025,9,9,18,9,170,172,342,171
Tree swallow,M026,8,9,17,8.5,170,183,353,176.5
Tree swallow,M027,8,9,17,8.5,174,174,348,174
Tree swallow,M028,8,8,16,8,173,181,354,177
Tree swallow,M029,8,8,16,8,173,174,347,173.5
Tree swallow,M030,9,9,18,9,175,176,351,175.5
Tree swallow,M031,7,9,16,8,174,176,350,175
Tree swallow,M032,8,8,16,8,175,180,355,177.5
Tree swallow,M033,8,8,16,8,174,180,354,177
Tree swallow,M034,6,9,15,7.5,172,178,350,175
Tree swallow,M035,8,8,16,8,176,177,353,176.5
Tree swallow,M036,8,8,16,8,176,179,355,177.5
Tree swallow,M037,8,9,17,8.5,178,181,359,179.5
Tree swallow,M038,8,9,17,8.5,172,174,346,173
Tree swallow,M039,8,9,17,8.5,176,180,356,178
Tree swallow,M040,8,8,16,8,175,176,351,175.5
Tree swallow,M041,8,9,17,8.5,173,177,350,175
Tree swallow,M042,8,9,17,8.5,173,176,349,174.5
Tree swallow,M043,8,9,17,8.5,176,179,355,177.5
Tree swallow,M044,8,9,17,8.5,173,182,355,177.5
Tree swallow,M045,6,8,14,7,174,178,352,176
Tree swallow,M046,8,8,16,8,172,173,345,172.5
Tree swallow,M047,6,9,15,7.5,170,174,344,172
Tree swallow,M048,8,8,16,8,176,179,355,177.5
Tree swallow,M049,8,8,16,8,168,171,339,169.5
Tree swallow,M050,8,8,16,8,179,186,365,182.5
Tree swallow,M051,8,9,17,8.5,173,180,353,176.5
Tree swallow,M052,8,8,16,8,173,175,348,174
Tree swallow,M053,8,9,17,8.5,176,181,357,178.5
Tree swallow,M054,8,8,16,8,177,177,354,177
Tree swallow,M055,8,8,16,8,173,184,357,178.5
Tree swallow,M056,8,9,17,8.5,170,175,345,172.5
Tree swallow,M057,8,9,17,8.5,174,185,359,179.5
Tree swallow,M058,8,8,16,8,176,178,354,177
Tree swallow,M059,8,8,16,8,172,172,344,172
Tree swallow,M060,8,8,16,8,173,173,346,173
Tree swallow,M061,8,9,17,8.5,176,181,357,178.5
Tree swallow,M062,8,9,17,8.5,168,170,338,169
Tree swallow,M063,8,8,16,8,172,174,346,173
Tree swallow,M064,8,8,16,8,175,180,355,177.5
Tree swallow,M065,8,8,16,8,172,176,348,174
Tree swallow,M066,8,9,17,8.5,174,183,357,178.5
Tree swallow,M067,8,8,16,8,174,176,350,175
Tree swallow,M068,8,8,16,8,176,178,354,177
Tree swallow,M069,8,8,16,8,172,174,346,173
Tree swallow,M070,9,9,18,9,171,173,344,172
Tree swallow,M071,8,8,16,8,172,172,344,172
Tree swallow,M072,8,9,17,8.5,173,176,349,174.5
Tree swallow,M073,8,8,16,8,174,175,349,174.5
Tree swallow,M074,8,8,16,8,172,173,345,172.5
Tree swallow,M075,8,9,17,8.5,172,173,345,172.5
Tree swallow,M076,8,9,17,8.5,173,181,354,177
Tree swallow,M077,8,8,16,8,173,181,354,177
Tree swallow,M078,8,8,16,8,173,180,353,176.5
Tree swallow,M079,8,9,17,8.5,170,172,342,171
Tree swallow,M080,8,8,16,8,170,173,343,171.5
Tree swallow,M081,9,9,18,9,173,178,351,175.5
Tree swallow,M082,8,8,16,8,174,178,352,176
Tree swallow,M083,8,9,17,8.5,172,175,347,173.5
Tree swallow,M084,8,8,16,8,174,176,350,175
Tree swallow,M085,8,9,17,8.5,164,179,343,171.5
Tree swallow,M086,8,8,16,8,172,173,345,172.5
Tree swallow,M087,8,8,16,8,173,176,349,174.5
Tree swallow,M088,8,8,16,8,172,174,346,173
Tree swallow,M089,8,8,16,8,174,176,350,175
Tree swallow,M090,7,9,16,8,176,178,354,177
Tree swallow,M091,8,8,16,8,171,173,344,172
Tree swallow,M092,9,9,18,9,172,172,344,172
Tree swallow,M093,8,8,16,8,175,175,350,175
Tree swallow,M094,8,9,17,8.5,172,178,350,175
Tree swallow,M095,6,8,14,7,173,180,353,176.5
Tree swallow,M096,8,8,16,8,173,174,347,173.5
Tree swallow,M097,8,9,17,8.5,174,179,353,176.5
Tree swallow,M098,9,9,18,9,172,174,346,173
Tree swallow,M099,6,8,14,7,172,174,346,173
Tree swallow,M100,8,8,16,8,173,176,349,174.5
Tree swallow,M101,8,9,17,8.5,173,176,349,174.5
Tree swallow,M102,8,9,17,8.5,174,177,351,175.5
Tree swallow,M103,8,9,17,8.5,173,185,358,179
Tree swallow,M104,8,9,17,8.5,174,177,351,175.5
Tree swallow,M105,8,8,16,8,175,185,360,180
Tree swallow,M106,8,9,17,8.5,176,183,359,179.5
Tree swallow,M107,8,8,16,8,173,183,356,178
Tree swallow,M108,8,8,16,8,176,183,359,179.5
Tree swallow,M109,8,8,16,8,175,175,350,175
Tree swallow,M110,8,9,17,8.5,182,189,371,185.5
Tree swallow,M111,8,8,16,8,173,175,348,174
Tree swallow,M112,8,9,17,8.5,172,181,353,176.5
Tree swallow,M113,9,9,18,9,173,175,348,174
Tree swallow,M114,8,8,16,8,175,175,350,175
Tree swallow,M115,8,8,16,8,178,183,361,180.5
Tree swallow,M116,8,8,16,8,176,180,356,178
Tree swallow,M117,8,9,17,8.5,173,174,347,173.5
Tree swallow,M118,8,9,17,8.5,174,175,349,174.5
Tree swallow,M119,9,9,18,9,173,176,349,174.5
Tree swallow,M120,8,8,16,8,174,175,349,174.5
Tree swallow,M121,8,8,16,8,170,176,346,173
Tree swallow,M122,9,9,18,9,174,174,348,174
Tree swallow,M123,8,9,17,8.5,178,178,356,178
Tree swallow,M124,8,8,16,8,168,172,340,170
Tree swallow,M125,9,9,18,9,174,175,349,174.5
Tree swallow,M126,8,9,17,8.5,175,183,358,179
Tree swallow,M127,8,9,17,8.5,170,175,345,172.5
Tree swallow,M128,8,9,17,8.5,175,179,354,177
Tree swallow,M129,8,8,16,8,180,183,363,181.5
Tree swallow,M130,8,8,16,8,177,181,358,179
Tree swallow,M131,8,8,16,8,177,178,355,177.5
Tree swallow,M132,8,9,17,8.5,170,172,342,171
Tree swallow,M133,8,8,16,8,166,174,340,170
Tree swallow,M134,8,9,17,8.5,176,182,358,179
Tree swallow,M135,8,8,16,8,168,185,353,176.5
Tree swallow,M136,8,8,16,8,170,173,343,171.5
Tree swallow,M137,8,9,17,8.5,173,178,351,175.5
Tree swallow,M138,8,9,17,8.5,174,176,350,175
Tree swallow,M139,8,9,17,8.5,175,176,351,175.5
Tree swallow,M140,9,9,18,9,176,180,356,178
Tree swallow,M141,9,9,18,9,174,174,348,174
Tree swallow,M142,8,9,17,8.5,172,176,348,174
Tree swallow,M143,8,9,17,8.5,174,174,348,174
Tree swallow,M144,8,8,16,8,176,178,354,177
Tree swallow,M145,8,9,17,8.5,175,177,352,176
Tree swallow,M146,6,8,14,7,170,181,351,175.5
Tree swallow,M147,8,8,16,8,175,178,353,176.5
Tree swallow,M148,8,8,16,8,174,175,349,174.5
Tree swallow,M149,8,9,17,8.5,173,180,353,176.5
Tree swallow,M150,8,8,16,8,174,178,352,176
Tree swallow,M151,7,8,15,7.5,178,185,363,181.5
Tree swallow,M152,8,9,17,8.5,172,177,349,174.5
Tree swallow,M153,8,9,17,8.5,178,182,360,180
Tree swallow,M154,8,9,17,8.5,173,176,349,174.5
Tree swallow,M155,9,9,18,9,176,176,352,176
Tree swallow,M156,8,9,17,8.5,174,175,349,174.5
Tree swallow,M157,8,9,17,8.5,173,178,351,175.5
Tree swallow,M158,9,9,18,9,174,186,360,180
Tree swallow,M159,8,9,17,8.5,170,181,351,175.5
Tree swallow,M160,8,9,17,8.5,173,176,349,174.5
Tree swallow,M161,8,8,16,8,173,176,349,174.5
Tree swallow,M162,8,8,16,8,174,180,354,177
Tree swallow,M163,8,9,17,8.5,178,183,361,180.5
Tree swallow,M164,8,9,17,8.5,172,175,347,173.5
Tree swallow,M165,6,9,15,7.5,173,178,351,175.5
Tree swallow,M166,8,9,17,8.5,173,176,349,174.5
Tree swallow,M167,8,9,17,8.5,170,178,348,174
Tree swallow,M168,8,8,16,8,174,186,360,180
Tree swallow,M169,8,8,16,8,172,183,355,177.5
Tree swallow,M170,8,9,17,8.5,170,172,342,171
Tree swallow,M171,9,9,18,9,180,183,363,181.5
Tree swallow,M172,8,8,16,8,174,176,350,175
Tree swallow,M173,8,8,16,8,174,175,349,174.5
Tree swallow,M174,8,9,17,8.5,178,180,358,179
Tree swallow,M175,7,9,16,8,172,180,352,176
Tree swallow,M176,7,8,15,7.5,173,175,348,174
Tree swallow,M177,8,8,16,8,173,176,349,174.5
Tree swallow,M178,8,9,17,8.5,175,186,361,180.5
Tree swallow,M179,8,8,16,8,173,174,347,173.5
Tree swallow,M180,8,9,17,8.5,174,182,356,178
Tree swallow,M181,8,9,17,8.5,170,178,348,174
Tree swallow,M182,8,9,17,8.5,171,178,349,174.5
Tree swallow,M183,8,8,16,8,174,174,348,174
Tree swallow,M184,8,8,16,8,172,183,355,177.5
Tree swallow,M185,8,8,16,8,172,173,345,172.5
Tree swallow,M186,8,9,17,8.5,175,185,360,180
Tree swallow,M187,8,9,17,8.5,176,180,356,178
Tree swallow,M188,9,9,18,9,174,177,351,175.5
Tree swallow,M189,8,9,17,8.5,166,173,339,169.5
Tree swallow,M190,9,9,18,9,174,181,355,177.5
Tree swallow,M191,9,9,18,9,176,176,352,176
Tree swallow,M192,8,8,16,8,174,176,350,175
Tree swallow,M193,9,9,18,9,171,175,346,173
Tree swallow,M194,8,8,16,8,173,174,347,173.5
Tree swallow,M195,8,8,16,8,170,176,346,173
Tree swallow,M197,8,9,17,8.5,174,176,350,175
Tree swallow,M198,8,9,17,8.5,176,182,358,179
Tree swallow,M199,8,8,16,8,172,180,352,176
Tree swallow,M200,8,8,16,8,175,180,355,177.5
Tree swallow,M201,9,9,18,9,173,174,347,173.5
Tree swallow,M202,9,9,18,9,172,172,344,172
Tree swallow,M203,8,9,17,8.5,174,177,351,175.5
Tree swallow,M204,8,8,16,8,176,178,354,177
Tree swallow,M205,8,8,16,8,173,175,348,174
Tree swallow,M206,8,9,17,8.5,169,176,345,172.5
Tree swallow,M207,8,8,16,8,174,176,350,175
Tree swallow,M208,9,9,18,9,173,177,350,175
Tree swallow,M209,8,8,16,8,179,181,360,180
Tree swallow,M210,8,9,17,8.5,172,179,351,175.5
Tree swallow,M211,7,8,15,7.5,180,181,361,180.5
Tree swallow,M212,8,9,17,8.5,173,175,348,174
Tree swallow,M213,8,8,16,8,172,176,348,174
Tree swallow,M214,7,9,16,8,176,185,361,180.5
Tree swallow,M215,8,8,16,8,170,172,342,171
Tree swallow,M216,8,8,16,8,174,176,350,175
Tree swallow,M217,8,9,17,8.5,173,173,346,173
Tree swallow,M218,8,9,17,8.5,179,181,360,180
Tree swallow,M219,8,9,17,8.5,166,178,344,172
Tree swallow,M220,8,8,16,8,181,183,364,182
Tree swallow,M221,8,8,16,8,174,181,355,177.5
Tree swallow,M222,8,9,17,8.5,174,177,351,175.5
Tree swallow,M223,8,9,17,8.5,176,179,355,177.5
Tree swallow,M224,8,8,16,8,172,175,347,173.5
Tree swallow,M225,8,8,16,8,174,179,353,176.5
Tree swallow,M226,8,8,16,8,173,185,358,179
Tree swallow,M227,8,9,17,8.5,170,176,346,173
Tree swallow,M228,8,8,16,8,173,178,351,175.5
Tree swallow,M229,8,9,17,8.5,174,176,350,175
Tree swallow,M230,6,8,14,7,173,176,349,174.5
Tree swallow,M231,9,9,18,9,173,174,347,173.5
Tree swallow,M232,8,8,16,8,170,173,343,171.5
Tree swallow,M233,8,9,17,8.5,173,176,349,174.5
Tree swallow,M234,7,8,15,7.5,174,185,359,179.5
Tree swallow,M235,8,8,16,8,174,183,357,178.5
Tree swallow,M236,8,9,17,8.5,178,180,358,179
Tree swallow,M237,6,8,14,7,172,173,345,172.5
Tree swallow,M238,8,9,17,8.5,171,174,345,172.5
Tree swallow,M239,8,8,16,8,172,172,344,172
Tree swallow,M240,9,9,18,9,176,181,357,178.5
Tree swallow,M241,8,9,17,8.5,171,178,349,174.5
Tree swallow,M242,8,8,16,8,174,179,353,176.5
Tree swallow,M243,6,8,14,7,170,170,340,170
Tree swallow,M244,8,8,16,8,174,174,348,174
Tree swallow,M245,8,8,16,8,173,174,347,173.5
Tree swallow,M246,9,9,18,9,176,182,358,179
Tree swallow,M247,9,9,18,9,174,176,350,175
Tree swallow,M248,8,8,16,8,174,184,358,179
Tree swallow,M249,9,9,18,9,174,180,354,177
Tree swallow,M250,8,9,17,8.5,171,174,345,172.5
Tree swallow,M251,8,8,16,8,173,178,351,175.5
Tree swallow,M252,8,8,16,8,177,180,357,178.5
Tree swallow,M253,6,8,14,7,173,175,348,174
Tree swallow,M254,7,8,15,7.5,173,174,347,173.5
Tree swallow,M255,8,8,16,8,174,177,351,175.5
Tree swallow,M256,8,9,17,8.5,172,183,355,177.5
Tree swallow,M257,7,8,15,7.5,173,174,347,173.5
Tree swallow,M258,8,9,17,8.5,173,174,347,173.5
Tree swallow,M259,8,9,17,8.5,178,186,364,182
Tree swallow,M260,9,9,18,9,176,178,354,177
Tree swallow,M261,8,8,16,8,177,183,360,180
Tree swallow,M262,8,9,17,8.5,170,172,342,171
Tree swallow,M263,8,9,17,8.5,173,174,347,173.5
Tree swallow,M264,8,8,16,8,172,174,346,173
Tree swallow,M265,8,8,16,8,175,176,351,175.5
Tree swallow,M266,9,9,18,9,175,179,354,177
Tree swallow,M267,8,9,17,8.5,176,178,354,177
Tree swallow,M268,8,9,17,8.5,174,179,353,176.5
Tree swallow,M269,8,9,17,8.5,174,177,351,175.5
Tree swallow,M270,8,9,17,8.5,176,178,354,177
Tree swallow,M271,8,8,16,8,176,181,357,178.5
Tree swallow,M272,8,8,16,8,167,180,347,173.5
Tree swallow,M273,8,8,16,8,175,175,350,175
Tree swallow,M274,8,9,17,8.5,173,177,350,175
Tree swallow,M275,8,8,16,8,176,179,355,177.5
Tree swallow,M276,8,9,17,8.5,174,178,352,176
Tree swallow,M277,8,9,17,8.5,180,184,364,182
Tree swallow,M278,8,9,17,8.5,177,178,355,177.5
Tree swallow,M279,8,9,17,8.5,173,175,348,174
Tree swallow,M280,6,8,14,7,174,174,348,174
Tree swallow,M281,8,8,16,8,176,185,361,180.5
Tree swallow,M282,8,9,17,8.5,172,176,348,174
Tree swallow,M283,9,9,18,9,176,178,354,177
Tree swallow,M284,7,9,16,8,173,174,347,173.5
Tree swallow,M285,8,8,16,8,173,173,346,173
Tree swallow,M286,8,9,17,8.5,177,181,358,179
Tree swallow,M287,8,9,17,8.5,176,177,353,176.5
Tree swallow,M288,9,9,18,9,172,176,348,174
Tree swallow,M289,8,9,17,8.5,174,178,352,176
Tree swallow,M290,8,8,16,8,170,181,351,175.5
Tree swallow,M291,8,8,16,8,174,176,350,175
Tree swallow,M292,9,9,18,9,177,178,355,177.5
Tree swallow,M293,8,8,16,8,168,185,353,176.5
Tree swallow,M294,9,9,18,9,176,176,352,176
Tree swallow,M295,8,9,17,8.5,173,176,349,174.5
Tree swallow,M296,8,9,17,8.5,178,179,357,178.5
Tree swallow,M297,7,9,16,8,175,176,351,175.5
Tree swallow,M298,7,8,15,7.5,174,181,355,177.5
Tree swallow,M299,8,8,16,8,177,181,358,179
Tree swallow,M300,8,8,16,8,170,177,347,173.5
Tree swallow,M301,8,9,17,8.5,174,181,355,177.5
Tree swallow,M302,7,8,15,7.5,176,177,353,176.5
Tree swallow,M303,8,8,16,8,176,176,352,176
Tree swallow,M304,8,9,17,8.5,173,185,358,179
Tree swallow,M305,8,9,17,8.5,176,187,363,181.5
Tree swallow,M306,8,8,16,8,182,183,365,182.5
Tree swallow,M307,8,8,16,8,173,175,348,174
Tree swallow,M308,8,9,17,8.5,176,189,365,182.5
Tree swallow,M309,8,8,16,8,172,176,348,174
Tree swallow,M310,9,9,18,9,164,178,342,171
Tree swallow,M311,8,8,16,8,170,176,346,173
Tree swallow,M312,8,9,17,8.5,173,179,352,176
Tree swallow,M313,9,9,18,9,172,173,345,172.5
Tree swallow,M314,8,9,17,8.5,178,179,357,178.5
Tree swallow,M315,8,9,17,8.5,173,173,346,173
Tree swallow,M316,8,9,17,8.5,170,173,343,171.5
Tree swallow,M317,8,9,17,8.5,170,179,349,174.5
Tree swallow,M318,8,9,17,8.5,172,178,350,175
Tree swallow,M319,8,9,17,8.5,173,175,348,174
Tree swallow,M320,8,8,16,8,176,178,354,177
Tree swallow,M321,8,9,17,8.5,172,173,345,172.5
Tree swallow,M322,9,9,18,9,173,174,347,173.5
Tree swallow,M323,8,9,17,8.5,174,176,350,175
Tree swallow,M324,9,9,18,9,172,173,345,172.5
Tree swallow,M325,7,8,15,7.5,174,183,357,178.5
Tree swallow,M326,8,9,17,8.5,173,183,356,178
Tree swallow,M327,8,8,16,8,174,176,350,175
Tree swallow,M328,8,8,16,8,170,178,348,174
Tree swallow,M329,8,9,17,8.5,172,174,346,173
Tree swallow,M330,8,9,17,8.5,175,182,357,178.5
Tree swallow,M331,8,9,17,8.5,174,182,356,178
Tree swallow,M332,8,8,16,8,177,180,357,178.5
Tree swallow,M333,8,9,17,8.5,174,176,350,175
Tree swallow,M334,8,9,17,8.5,174,177,351,175.5
Tree swallow,M335,9,9,18,9,174,174,348,174
Tree swallow,M336,8,8,16,8,174,183,357,178.5
Tree swallow,M337,8,8,16,8,170,170,340,170
Tree swallow,M338,9,9,18,9,174,174,348,174
Tree swallow,M339,8,9,17,8.5,173,176,349,174.5
Tree swallow,M340,8,9,17,8.5,173,174,347,173.5
Tree swallow,M341,8,8,16,8,174,178,352,176
Tree swallow,M342,8,9,17,8.5,172,173,345,172.5
Tree swallow,M343,8,8,16,8,169,180,349,174.5
Tree swallow,M344,8,8,16,8,173,178,351,175.5
Tree swallow,M345,8,9,17,8.5,173,175,348,174
Tree swallow,M346,8,8,16,8,179,183,362,181
Tree swallow,M347,8,9,17,8.5,176,179,355,177.5
Tree swallow,M348,8,9,17,8.5,174,180,354,177
Tree swallow,M349,8,8,16,8,177,178,355,177.5
Tree swallow,M350,8,9,17,8.5,176,182,358,179
Tree swallow,M351,8,8,16,8,164,174,338,169
Tree swallow,M352,8,9,17,8.5,172,173,345,172.5
Tree swallow,M353,8,9,17,8.5,172,172,344,172
Tree swallow,M354,8,9,17,8.5,170,175,345,172.5
Tree swallow,M355,8,9,17,8.5,173,173,346,173
Tree swallow,M356,6,8,14,7,182,183,365,182.5
Tree swallow,M358,8,9,17,8.5,172,174,346,173
Tree swallow,M359,8,8,16,8,173,177,350,175
Tree swallow,M360,8,8,16,8,174,174,348,174
Tree swallow,M361,8,9,17,8.5,173,178,351,175.5
Tree swallow,M362,8,8,16,8,178,181,359,179.5
Tree swallow,M363,8,8,16,8,179,179,358,179
Tree swallow,M364,8,8,16,8,173,178,351,175.5
Tree swallow,M365,8,8,16,8,176,178,354,177
Tree swallow,M366,9,9,18,9,174,179,353,176.5
Tree swallow,M367,8,8,16,8,172,173,345,172.5
Tree swallow,M368,8,9,17,8.5,175,177,352,176
Tree swallow,M369,8,9,17,8.5,175,180,355,177.5
Tree swallow,M370,8,8,16,8,174,181,355,177.5
Tree swallow,M371,9,9,18,9,178,178,356,178
,,,,,,,,,
,,,,,,,,,
,,,,,,,,,
,,,,,,,,,
,,,,,,,,,
,,,,,,,,,
,,,,,,,,,
,,,,,,,,,
,,,,,,,,,
,,,,,,,,,
,,,,,,,,,
